##########
# .  #####
# $   $ ##
# #  #@ ##
# ########
# ########
# #. #####
# $  $ ###
#.  .   ##
##########