##########
##########
##########
##########
#. @######
# $$$. ###
# .  $ ###
# ####  ##
# .      #
##########