##########
#     ####
# .#     #
#       .#
## #     #
##  ######
#   ## ###
# $$$.@$ #
##   .   #
##########