##########
#. #######
# $#######
#  # #####
#..$ #####
# .$ #####
#  # #####
#$#  #####
# @  #####
##########