##########
##    . .#
##$$ $ . #
#  ####$ #
#  ####  #
##   .## #
#     ## #
#        #
####   @ #
##########