##########
# $.  ####
# .  $@###
# ### ## #
# ##     #
#  #### $#
# $ ###  #
#   # # .#
## .     #
##########