##########
### .    #
### $##. #
###@ ##$ #
### ###  #
###. .$$ #
### ##   #
######## #
######## #
##########