##########
#@$  $ ..#
# $. . $ #
###   ####
##########
##########
##########
##########
##########
##########