##########
#     ####
#   $ #@##
# . #  $##
#  ## #. #
# ####  ##
####  $ ##
##### .$ #
####  .  #
##########