##########
##    ####
##  . ####
### $ ####
#@$ ######
#$$  #####
#  .######
#. .######
#    #####
##########