##########
#####  ###
##### ####
#####  #.#
####  ##.#
###@$  $ #
#### $ $ #
### .##  #
###  .   #
##########