##########
##   #####
## .$@####
##  $ ####
### .#####
### $#####
###. ### #
## .$ ## #
#        #
##########