##########
#   .@####
# $$$ ####
### ######
### ######
##   #####
#  .######
#   $ ####
# .    . #
##########