##########
#.  .. ###
# $ $ ####
# ##  ####
# ###@####
# ### ####
####. ####
## $ $####
##     ###
##########