##########
#.#### . #
# $      #
# $ $.$  #
# #### . #
# ##### ##
# ########
# ########
#  @######
##########