##########
##########
##########
##########
#@      ##
#$# # ####
#  # $$  #
#.$ ..  .#
#        #
##########