##########
####   . #
####   . #
#### .#. #
#####$$  #
###@$  $ #
####  #  #
####### ##
##########
##########