##########
# @  #####
#.$  #####
#$#$  ####
#     ####
# # .#####
#  # #####
#.$#######
#  .######
##########