##########
##########
#   ######
## #     #
## $$ .  #
#      $ #
## $### ##
##. ##.@ #
##   .   #
##########