##########
##   #   #
### $#   #
##@$.    #
### $# $ #
##  .#   #
##  ##  ##
###  ##. #
##  .    #
##########