##########
#  .@    #
# $ $ $. #
#######$##
####### ##
####### .#
######   #
###### . #
######  ##
##########