##########
#   ######
# .$######
#   ######
#  $######
# .$ #####
#  . #####
###$.#####
###@######
##########