##########
##########
##########
##########
#@    ####
# $.$ ####
#..#######
# $####  #
# $ .    #
##########