##########
#   . ####
# $ .   ##
#  #  ####
# #@$. ###
# #$  ####
# #   ####
# # $#####
#   . ####
##########