##########
#####   ##
#####  .##
#####  # #
#####  $ #
####@$   #
##### $..#
#### ##$.#
####     #
##########