##########
#     .  #
#   $ #$ #
# #####  #
#. ##  $ #
#  $  @ .#
#      . #
###### # #
##########
##########