##########
#   ######
#@ #######
#  #######
# ########
# .$ #####
# $.  #  #
# $#  #$ #
#   . .  #
##########