##########
##########
#######@ #
#######$ #
#######  #
#######$ #
#### ##  #
# $   .$ #
#.    . .#
##########