##########
##  @    #
# $    $ #
#  . .## #
#  #### .#
#  ####$ #
#      $ #
##.  # # #
##########
##########