##########
##########
##########
##########
# ###### #
# ###  . #
# ###$#..#
#@. $ $$ #
##       #
##########