##########
#      .##
#  .$.$ ##
#.$#######
# $@######
#  #######
##########
##########
##########
##########