##########
##.   . ##
##  $ $ ##
### ## ###
##.$@#####
###$######
##  ######
#   .  ###
#     ####
##########