##########
######   #
#######$ #
######.  #
##   # . #
##  ### ##
##@$ #. ##
## $   $ #
#    #  .#
##########