##########
##### .  #
#####  $.#
######$  #
##### .$.#
# ####   #
#   #### #
#  #### $#
#      @ #
##########