##########
#      @##
# $ .$$.##
####  ####
#### $ ###
##### ####
####  ####
####   ###
#  .   . #
##########