##########
##########
##########
#    #####
#.  $# ###
#     .###
#    # ###
# $ $# $ #
# .   @ .#
##########