##########
#     ####
# ..$ ####
# ##$#####
#.    ####
#     ####
# $.$@####
###   ####
#### #####
##########