##########
##########
####.# ###
#       ##
# .   . ##
# ###   ##
# ####  ##
# $  $$###
# .   $@##
##########