##########
#  ..  ..#
#  # #  @#
# #  #   #
# $ $    #
###   $  #
#######  #
###### $ #
#######  #
##########