##########
#        #
#. $ .   #
##       #
#####$## #
#####    #
##### $###
##### $ ##
#### ..@##
##########