##########
###     ##
## .@$$###
#     $ ##
#$ ##   ##
# ##### ##
#  #     #
#.#      #
# .  .####
##########