##########
# ########
# ########
#  #######
# $#######
#  #######
#.$## ####
#.  .$ $@#
#   .    #
##########