##########
##########
##########
######. ##
###### $ #
######.  #
##### .$##
# ## .$$ #
#     @  #
##########