##########
##@#######
# $#######
#  #######
# . ######
#. .##   #
# $###   #
# $    $.#
##  #    #
##########