##########
#     ####
#     ####
# ########
#  #######
#  . #####
# $$$@####
# ..$ ####
#  .######
##########