##########
#### #####
#   .#####
#  $ #####
#  # #####
#   $  $@#
#  $  #  #
#  .# ## #
##. .    #
##########