##########
##  # .###
## @$   ##
###   $$ #
##  #    #
#   #    #
#   #. $.#
# ###  .##
##########
##########