##########
##########
###### . #
######   #
#######$ #
###@# #. #
#  $ .   #
##   $ $ #
#######. #
##########