##########
######   #
###### $ #
#######. #
###### $ #
######   #
#   ## $##
#. $ # @##
#  .   . #
##########