##########
######## #
######## #
# . #### #
#  $##   #
#  $   $ #
##.. #   #
# $###   #
# @####. #
##########