##########
##########
##  ######
##      .#
#@$ $.   #
##     $ #
##   .####
## $#  ###
### .  ###
##########