##########
#       ##
# $  .####
# $. #####
#.$.######
#  #######
# ########
#$ #######
#@########
##########