##########
#      ###
#.. $ ####
#  ##.####
#$##.  ###
# ##   ###
#  #$$ ###
#  # @ ###
#  ### ###
##########