##########
# ..   ###
#. $$#####
#. #  ####
# $ $  ###
# @    ###
##########
##########
##########
##########