##########
#        #
# ## #.$ #
# ######.#
#  ##### #
#.   ##  #
##   ##  #
###$   #$#
###.  $@ #
##########