##########
##   ##@##
##  . $$##
####.#$ ##
# ####  ##
# #####  #
# .###   #
# $#     #
#       .#
##########