##########
####  .. #
##### $  #
##### $..#
###### $ #
####### $#
####### @#
##########
##########
##########