##########
#        #
# .  $ $ #
# ########
#  #######
# @#######
# # ## ###
# $   .###
#.  .$ ###
##########