##########
##########
####### ##
#  .    ##
###  $#. #
##@$ $ . #
##  ##  ##
###$# #  #
#   .    #
##########