##########
#.  .    #
###  $ ###
####.  ###
##   $####
### .  ###
####  ####
####$$####
###@  ####
##########