##########
#     ####
#.#   ####
# ########
# ########
# #    ###
#   $$ $ #
#.  . .$@#
##########
##########