##########
#     ####
#  #######
# ##. ####
#    $ ###
# $ $. ###
#  ## ####
# ##  ####
#  #..$@##
##########