##########
# ########
# #  #####
#  $@#####
#.. ######
#   .#####
#  $######
#$.$ #####
#     ####
##########