##########
###### ###
#      ###
#.## $ ###
#  ##  ###
# $##  ###
#@ ##$ ###
#$ ##.# ##
# .  .   #
##########