##########
#######  #
##### #$.#
##### .$ #
##### $  #
####  ## #
####  #  #
#####@ $ #
#### .  .#
##########