##########
## ..    #
#    #   #
# #####  #
#  # #  ##
# .    $@#
#.  $ $ ##
# $#######
#   ######
##########