##########
####### .#
###### .$#
###@$  $ #
#### $   #
########.#
#######  #
########.#
##########
##########