##########
#####    #
### $   .#
###  .$  #
#######@ #
######## #
#  #.### #
#   $  $ #
# .  #   #
##########