##########
#. .    ##
#    # ###
# $#######
#  #######
# ########
#.##### ##
#.$  $ $ #
#       @#
##########