##########
###@###  #
###      #
## $  #$ #
## $ ##. #
##.. ##  #
##  ### .#
# $ ######
#    #####
##########