##########
#    #####
#.  $ ####
#.#   ####
#.#  #####
#$#  @  ##
#. #  $ ##
# #   $ ##
#      ###
##########