##########
##########
##  #  ###
##$   .  #
# $      #
# $ ####.#
# @####  #
######.$.#
######   #
##########