##########
##########
##########
##########
# . @#####
#  .  .  #
#.$$ $ $ #
#  #######
# ########
##########