##########
# $   .. #
# $. $   #
# #   # ##
#@## $####
# ##. ####
##########
##########
##########
##########