##########
##########
##########
##.#  #@##
##    #$.#
#   # #  #
#  ## $  #
# $ ## $ #
#    . .##
##########