##########
#  #######
# .#######
## . #####
##  $#####
###. #####
##  .##  #
##  $$ $ #
## @     #
##########