##########
#  #######
# ########
# # ######
#   ######
#. $@#####
#  $.#####
# $$######
#.. ######
##########