##########
####  ####
##      .#
#### $   #
#######  #
## ##### #
##  ###. #
# $   #$ #
#@$   .. #
##########