##########
###..  $ #
##  #    #
# $ ###$ #
##.####  #
###  ### #
##  #### #
# $.#### #
#  @     #
##########