##########
# ##  ####
#   .$@###
#$. $ ####
# $#  ####
#..#######
# ########
# ########
##########
##########