##########
#####@####
#####$####
# $.  .###
#  #   .##
#   #  ###
#  ##   ##
# $ #$ ###
##      .#
##########