##########
##########
##########
## ###@###
# ..  $###
#   $  # #
#  ##  # #
# ###$ $ #
#     .. #
##########