##########
##########
##########
##########
#  #######
#  .#.  ##
#    $ $ #
# . $  $@#
#  . #####
##########