##########
##########
##########
## #@## ##
#   $   ##
#     $ ##
#.####. ##
#. ###$ ##
#  $  .  #
##########