##########
##   #  ##
## . $.$@#
###   $$##
######  ##
#######  #
#####    #
#####  ..#
######   #
##########