##########
#  . .####
#  $. ####
#  ## .###
# $# $ ###
#     @###
#   # ####
# $  #####
#   ######
##########