##########
###### . #
###### $ #
#######  #
###.@##$ #
###  ##  #
###  # $ #
#.  $   .#
###  #  ##
##########