##########
#      ###
#  #   ###
#.$## ####
#  #######
# $###  ##
#  .    .#
#.  ##$$@#
#  ##    #
##########