##########
#       ##
#  $ $ ###
#  ### ###
# #    ###
#  $##.###
# .$ #@###
#..  #####
###  #####
##########