##########
#   . $ ##
#   $ #  #
# .### $ #
# $ ##   #
#. ###   #
#  ###.  #
######@  #
######   #
##########