##########
##########
##########
###### ###
##       #
##. $.$ .#
###. #   #
# #####$$#
#  @     #
##########