##########
#..$ #####
# $..#####
#       ##
#$$# #####
# @#######
##########
##########
##########
##########