##########
# .#######
#.   #####
#   ######
# .$## # #
##  $    #
##  $  $@#
#######  #
####### .#
##########