##########
# $    . #
#. @.$ $ #
####### .#
#####  $ #
#######  #
##########
##########
##########
##########