##########
##########
##########
##########
## #######
#.   $ ###
# $$#  ###
# .$@# # #
#  . .   #
##########