##########
####     #
#####@$. #
#####  $.#
##### #$ #
#######. #
#######  #
####### $#
##### .  #
##########