##########
##    . .#
##  #  $ #
### ##$ ##
### $ .$@#
### .   ##
##########
##########
##########
##########