##########
#####.  .#
#####  $ #
####  #$.#
###  ## .#
###  ##$ #
###  ##  #
###  #@$ #
###      #
##########