##########
##    .# #
##.@   # #
#####$.$.#
#####    #
#######$ #
#######  #
#######$ #
#######  #
##########