##########
#    @.  #
# $ $ $. #
#.$#######
# .#######
#  #######
# ########
#  #######
#  #######
##########