##########
##########
##########
##########
# ########
#  # @####
# ##$$.###
#  # $.  #
#  . .$  #
##########