##########
#    . ###
#     @###
# $## ####
# . ######
# $ ######
## $ #####
## $ #####
#    ..  #
##########