##########
#        #
# . $ #  #
#.#####  #
# #####  #
#  ##### #
#. #######
#    $ $ #
#  ##. $@#
##########