##########
#   ######
#  $######
#   ###  #
#..   $$ #
#  # ##  #
####### .#
#######$ #
#######@.#
##########