##########
# .  .  ##
#$  $ .###
#  #######
#.  ######
# $ $@####
#    #####
# ########
##########
##########