##########
####     #
#####  $ #
#######  #
#######  #
######## #
### ##  @#
#..$ $.$ #
##      .#
##########