##########
#######. #
#######  #
####### .#
# # ###  #
#    $   #
# $ .  $ #
#@ .$ ####
#    #####
##########