##########
##########
##########
#@########
# # #  ###
# $  $ $ #
# $.  .  #
##. ######
#   .#####
##########