##########
##### #  #
#  .  .. #
# $ $  $ #
# #####  #
# ###### #
####  ## #
####.  $@#
####   # #
##########