##########
####### .#
#######$.#
#######  #
#######  #
#######  #
#######$.#
##### .$$#
#### @   #
##########