##########
##########
##########
#####  . #
###### $ #
#@#  #   #
#$  ###$ #
#. $###  #
#.   .   #
##########