##########
##########
######@###
####  $###
#####  ###
#####   ##
######$ ##
# $.#   ##
#   ..$. #
##########