##########
###.   @ #
#### $ $.#
###  ###.#
##       #
### .#   #
###### # #
###### $$#
######   #
##########