##########
#  #######
#$@#######
# ########
#    #####
# $. #####
#..$  ####
# $. #####
#  #######
##########