##########
####     #
#####$.$ #
#### @## #
####    .#
##### .$.#
#######  #
#######$ #
#######  #
##########