##########
######  .#
###  ## .#
#### ## .#
#### ##  #
# ## @#  #
#  . $ # #
# $ $   $#
#####    #
##########