##########
##  .    #
###  .$  #
##@$ .#  #
### $.$  #
####  #  #
##########
##########
##########
##########