##########
##       #
## .. #  #
#    ## .#
# .  ##  #
#   ###  #
###  $   #
## $$ $  #
##@ ###  #
##########