##########
##########
# ########
# ########
# ########
#  #######
# $.######
#.$ $    #
#@$ . . ##
##########