##########
###@$  . #
####$$ . #
####.##$ #
#######  #
#######. #
##########
##########
##########
##########