##########
# ## ## ##
#.      ##
# .$ $$  #
#   ##  .#
######   #
######  ##
######$@##
####   . #
##########