##########
##########
##########
##########
##########
#####  ###
#@$.   ###
# $ #.$ ##
# .$.   ##
##########