##########
##########
##########
##########
######  ##
##. ##  ##
# $ .$ $@#
#  .. $ ##
#  #    ##
##########