##########
##########
#  #######
#  #######
#  #######
# ########
#    #####
# $.$.$ ##
#  . $@. #
##########