##########
####  ####
#### $  ##
#.     $ #
# $###  ##
#  ####.##
#  ###  ##
#$.# #   #
#@ .     #
##########