##########
#     .  #
#  #.  $ #
#. ###   #
# ##### ##
# ####  ##
#  ###  ##
#$$####$##
#@   .  ##
##########