##########
##########
##########
##########
###### .##
###### $##
######. .#
## # $ $$#
## @.    #
##########