##########
##########
########.#
######## #
##  ###  #
##$@###$ #
#  .###  #
# $# # $ #
#  .   . #
##########