##########
##       #
##.  . $ #
#   ##@  #
## ####  #
#  ####$ #
#. ####  #
#$ ### $ #
# .#     #
##########