##########
##########
##########
#.########
# ########
# #  #####
# # $#####
# .  $ ###
#  $ .$@.#
##########