##########
##########
#######@##
###     ##
# ##$$ .##
# ## #####
#    #####
#  $ #   #
#..$   . #
##########