##########
#####   .#
##     $ #
####  $ ##
#   ##  ##
##  . $$##
#     #@##
#  .######
# . ######
##########