##########
##### ####
### @ ####
#     ####
# $# #####
#..#  ####
# $#  ####
# $. #####
#. $ #####
##########