##########
##     ###
## $$ ####
##. ######
##  #### #
###  ### #
# . ### .#
#   .  $$#
#@ #     #
##########