##########
# ####. ##
#  ### $@#
# $ #   ##
# . #$   #
#. $.   ##
#    #  ##
##########
##########
##########