##########
###. ### #
##  .##  #
##  #.## #
### $.   #
###   $$ #
####### @#
#######$ #
#######  #
##########