##########
######## #
##### $ .#
###  .  .#
###$  ## #
###  #####
### $#####
#@$    ###
##  .   ##
##########