##########
# ########
#  #######
#. #######
#  #######
#  #######
#      @ #
# $# .$$ #
#   # $..#
##########