##########
#@.   . ##
# $ $$$ ##
# ### ####
#  ##  ###
# ### ####
#.### ####
# ##.  ###
#       ##
##########