##########
#######  #
#######$.#
#  @###  #
#  #### .#
# #####$ #
# $      #
# $ .#.  #
#######  #
##########