##########
##########
##########
##########
##########
#####  ###
##  .# ###
# $ .$.$ #
#@$     .#
##########