##########
###   @  #
#### $ $$#
###  ##. #
####  # .#
###  . $ #
####  #  #
#######. #
##########
##########