##########
# .   ####
#  $. ####
####$  ###
#. #   ###
#@ ##.####
#  #   ###
#  $ $ ###
#       ##
##########