##########
####  ####
#    $####
#.     ###
#  ###$  #
#  ###. ##
# ####.$@#
# # $   ##
# .      #
##########