##########
###.  . ##
# $$$$@ ##
# .   ####
#  .######
# ########
#  #######
#  #######
#  #######
##########