##########
##########
##########
####  ####
####  .$@#
#### $## #
#### $   #
## $  ##.#
#   .  . #
##########