##########
## $ .  ##
#  . .$ ##
#   ##   #
######$ ##
###### @ #
#######.##
#### $   #
##       #
##########