##########
###     ##
### . $. #
#  $ $  ##
##. .  $@#
##########
##########
##########
##########
##########