##########
####.   .#
####.    #
#     ##.#
#  #  #  #
# $ ##  @#
# $ #### #
# $$ #####
#    #####
##########