##########
#    #####
#  $ #####
# ########
# ########
#   ###  #
#  . .$. #
#  $   $ #
#.####@ ##
##########