##########
###      #
#. #  #  #
#     ## #
#   $ #  #
## #### .#
## $ ### #
##.$     #
#### $@. #
##########