##########
### ######
###    ###
### $ ####
## . ### #
# # ###  #
#  .   $ #
#  $.  $@#
#  .#### #
##########