##########
#   ######
##$@######
## ##  ###
##    ####
## .#.####
# $ #$ ###
# .  $.  #
#       ##
##########