##########
##########
#.@ ######
#$$#######
#  #######
# $ $.  ##
#  .#   ##
#.####   #
# ##### ##
##########