##########
####@#####
####$#####
###   # ##
#### $.  #
###   .  #
### $##$ #
###   #. #
####  .  #
##########