##########
#  . .   #
#  @$    #
#   ##$###
# ###.  ##
#. $  $###
##     ###
##########
##########
##########