##########
#  @     #
# $ $# ###
### .#####
####.#####
#### .####
#.##  ####
#$# $  ###
#     ####
##########