##########
#  #######
#.  ######
#    #####
#       ##
#    $.  #
#  $ #$  #
## . #.$##
##  ###@##
##########