##########
##########
##########
######@###
######$###
#####. .##
#####$ $##
#  # $  ##
# .    . #
##########