##########
##########
##########
# ##### @#
# .   $  #
# $. . $ #
#. ###$###
# #### ###
#       ##
##########