##########
# $ .#####
#. #######
# ########
#  #######
# ##.  ###
#   $ ####
#  $.$@###
#     ####
##########