##########
##########
##########
#  ###  ##
# ..   $ #
#.$ #    #
#   ###  #
##$####$ #
#. @     #
##########