##########
##########
##########
##### ####
#####@   #
####  .$$#
####  #..#
#####$$  #
####  .  #
##########