##########
####     #
####$$ # #
####. # .#
####  #$ #
####@.   #
####### .#
#######$ #
#######  #
##########