##########
# @#   ###
# $$$$ ###
# .    ###
#### .####
##### ####
####    .#
###      #
#### .  ##
##########