##########
# . .  . #
#@$  $ $ #
# $#### ##
##.###   #
## ####  #
####### ##
##########
##########
##########