##########
#        #
#@..$$.  #
#.   $ # #
# $##### #
#  #######
# ########
#  #######
#  #######
##########