##########
##       #
###.# . .#
##   $ $ #
##  ##. ##
#   #  ###
#    $  ##
#  ###$###
#####@ ###
##########