##########
##########
##########
#### #####
## . .  ##
##  $  ###
##.  ##@##
## $$# $ #
##.      #
##########