##########
##########
####.#####
#. $$#####
#.$  #####
#  #######
# .#######
#$ #######
#@ #######
##########