##########
##.   . ##
##   #  ##
##@$ #####
##$  #####
##  ######
###$ #####
##  . $ ##
#    .   #
##########