##########
#. $  $..#
#  #.  $ #
######## #
### $    #
###      #
######## #
#######  #
####### @#
##########