##########
#      @ #
# .$.  $ #
#  # .#  #
####$$## #
#### .   #
##### #  #
##########
##########
##########