##########
#@# ######
#$    ####
# $ ######
#. #######
# $#######
# $   ####
#. .. ####
#    #####
##########