##########
#  #######
#.$@######
#  $######
##  .    #
##     $ #
## ##.   #
# $##. ###
#      ###
##########