##########
#   ###@ #
#$$  ##$ #
#  .$    #
# .   #  #
#. .######
##########
##########
##########
##########