##########
#  #######
#. #######
#   ######
# ########
#  $ #####
#.$$ .####
# .$ @####
#  #######
##########