##########
####     #
###  # $@#
#### #  ##
###### $ #
##### #  #
##.    $ #
##   . $.#
###### .##
##########