##########
######   #
##### $$ #
######   #
###### $ #
#  ###.###
##  #   @#
#  ### $ #
# .   .. #
##########