##########
##########
##########
##########
##########
# ####.# #
#. $ @   #
# #$ #$$ #
#   ..   #
##########