##########
# ########
#..#######
#  #######
# $###. ##
#  ###   #
#$$    $ #
#@#   # .#
##########
##########