##########
##       #
###@ ..$$#
##### $# #
######.  #
#######  #
#######$.#
#######  #
#######  #
##########