##########
##########
##########
##########
##########
#      ###
# $.$ # .#
## $# # $#
# .  .@  #
##########