##########
# ####   #
#.###.  .#
#  ##    #
#  ###$ ##
# #    $##
#.#   $@##
#   $#####
#    #####
##########