##########
##########
##########
#######  #
### ##.$ #
#@$. $ . #
#   ##   #
# #####$.#
# #####  #
##########