##########
##########
#######  #
#######$ #
####### .#
#######$ #
####### .#
#### # $@#
# .  . $ #
##########