##########
#    #####
#    #####
#  #######
# ###@####
#  .$$####
# $..  ###
# $  . ###
####     #
##########