##########
#####. ###
#####   ##
# ###  .##
# ####  ##
# ## #  ##
#@$    ###
# #$$. ###
# $.  ####
##########