##########
##########
#####  # #
#### $. .#
##@$   $.#
###  #   #
#   ### .#
#   ###$ #
# #####  #
##########