##########
######. .#
###### $ #
#######  #
######   #
#######$ #
###### @ #
#######$ #
#####. $.#
##########