##########
###  #####
## $  ####
## . #####
##  $#####
###$.@####
###  #####
## $ #####
##  .  . #
##########