##########
#. .   ###
#    $ ###
#  ##   ##
# ### $ ##
# @###  ##
#  ##  ###
# ###$$###
#  .  .  #
##########