##########
#  ..    #
#.   # $ #
#  ### ###
#  ## .###
#$$$   ###
#  @## ###
##########
##########
##########