##########
####### @#
###### $$#
######   #
#######..#
###### . #
######$  #
######.$ #
######   #
##########