##########
##########
##########
##########
##########
#  #######
#.$ $ ####
# .$$.  .#
#@       #
##########