##########
##########
#### #####
#### ##@##
#      $ #
#   .#   #
# .####  #
# .$ $.$ #
#        #
##########