##########
# ########
# ########
#. #######
# $ ######
# .$@#####
#  $######
#$ . #####
# .   ####
##########