##########
#######  #
### . #$ #
### $ #  #
###@  # .#
###  $   #
###   ## #
####$###.#
### .    #
##########