##########
#  ..    #
# ## . . #
#    $ ###
### #  ###
### #  ###
##  #  ###
###$ $$###
##  @  ###
##########