##########
#  #######
# .# #####
#   .. ###
# $ $ ####
#.##  ####
# ### ####
# $ $ ####
#    @####
##########