##########
#@$    . #
# $   $. #
####. .$ #
######## #
######## #
#######  #
######## #
##########
##########