##########
#@    ####
#$. $ ####
# $#######
# .#######
#. #######
# ##  ####
# ###  ###
# $ .  ###
##########