##########
#   ######
# $ ######
# $  ##@##
#   .# $##
#    ..  #
#.   #   #
###### $ #
######   #
##########