##########
# .   .###
#  ##. ###
# ###   ##
# ###$.###
# #  $  ##
#     $ ##
# $# @####
#  #######
##########