##########
#.       #
#  # $. .#
#  ####  #
# #####$ #
# #####  #
# .##### #
#    $@$ #
#  #  ####
##########