##########
######.$ #
###### $ #
####### .#
#######$ #
#######  #
#######. #
#####@$  #
###   .  #
##########