##########
# .     ##
#@$ $.  ##
##   # .##
##   ##  #
##.$##   #
##   #  ##
###$# # ##
###      #
##########