##########
##########
##########
##########
#######@ #
###### $$#
####   $ #
#### $ # #
#.   .. .#
##########