##########
#   ######
# . ######
# . ######
#  #  ####
#  $  $@##
#  $. ####
## $ #####
#.      ##
##########