##########
#     .  #
#   ## $ #
# #####  #
# #####$ #
#  ####. #
# ##  .  #
# $@   # #
##. $ ####
##########