##########
## $  .$.#
##@$..$  #
######   #
###### ###
##########
##########
##########
##########
##########