##########
##########
#   .  ###
# $   @###
# ##.  ###
# .# $ ###
#  $ #####
# $ ######
# . ######
##########