##########
##.   .$ #
## $  $  #
######@. #
#######$ #
#######  #
#######  #
#######. #
######   #
##########