##########
##########
##########
##########
#   ######
# $. .####
#   #  .##
# $## $###
# .  $@###
##########