##########
#  @    .#
# $$ $ .$#
#  ####  #
# ######.#
#  #######
# ########
#  #######
#.########
##########