##########
########.#
#######  #
#######  #
##   ## .#
#  $  ##$#
##   ##@ #
# $#### $#
#     .. #
##########