##########
##########
##########
##  # ## #
# $  $ $@#
#.  ...$ #
#   # ####
#  #######
#  #######
##########