##########
#######  #
#####. . #
##### $$ #
######@$.#
#######  #
#######$ #
####### .#
#######  #
##########