##########
##### .  #
#######$.#
#@##### .#
# ###### #
#  ####  #
# $# ### #
# $      #
# $   .  #
##########