##########
#### @.  #
#       .#
# $  #.$##
### ##  ##
###  # ###
## $$. ###
###    ###
##########
##########