##########
##########
##########
#  #######
# ########
# .  #####
#. $$#####
#  .$ ####
#    .$@##
##########