##########
## # ##  #
#@..   . #
# $  #   #
# $$### .#
#   #### #
#######  #
####### $#
#######  #
##########