##########
##########
########@#
######## #
####   . #
####$$.$.#
### .##  #
###   #$ #
###   #  #
##########