##########
# ########
#  ###  ##
# ####$.##
# ####. ##
#  ####. #
#  ####  #
# $$   $ #
# .@     #
##########