##########
##########
##########
####  ####
#  $  ##.#
#     #  #
# $$$    #
##  . # @#
#####. . #
##########