##########
###@.# ###
## .$   .#
###  #   #
###$###$ #
##  ###  #
### #### #
#    ## $#
#     .  #
##########