##########
#####  . #
####### ##
#   . . ##
# #   $.##
# ##  ####
# $  $  ##
# $   @###
#  #######
##########