##########
###  ##  #
##  $ $  #
###  ##@##
###  #  .#
###     ##
####.##  #
####$.$ ##
####    .#
##########