##########
#      ###
#.$ $$####
# ### ####
# ## $   #
# @.     #
# ##  .  #
#####   .#
######   #
##########