##########
##########
##########
#  # #  ##
# $ .$   #
# $#  ...#
#    ## @#
# $ ######
#    #####
##########