##########
#    . $@#
###. $$$ #
##### .###
##### ####
#### .# ##
####    ##
####### ##
##########
##########