##########
# ..   $ #
#  . $$$@#
#  ##. ###
#####  ###
##########
##########
##########
##########
##########