##########
##########
##########
#@### ####
#. ## ####
#$$#  .###
#  $     #
# .# $   #
#.##   ###
##########