##########
#######  #
#######$ #
#######  #
#######. #
#@# ####.#
# $     .#
# $ $   .#
# ###    #
##########