##########
#####    #
#### $$$ #
###  @.$ #
#### ##. #
####  #  #
###  ##  #
### .##  #
#      . #
##########