##########
#        #
#      ..#
# ## ##  #
#.$. ##  #
##$  ##  #
# $ $@#  #
#    #####
##########
##########