##########
# . ######
# $    ###
#  .  ####
#.$ # ####
#  #######
# ########
#$ $ #####
#.  @#####
##########