##########
##########
##########
# ########
#   #@ ###
#.$###  ##
#   .$ ###
#  .$$.###
#     ####
##########