##########
##########
####   ###
#.# @    #
#      $ #
#.$ # #  #
# $ ######
#.$ ######
#.########
##########