##########
#####.@  #
####    .#
# $ $ #  #
# $   #  #
# $####  #
#. ##### #
# .####  #
#        #
##########