##########
#  @    ##
# $$ $  ##
# .   #  #
######  ##
######  ##
# #####. #
#  ###  ##
#.    $. #
##########