##########
##########
##########
##########
##########
#@ #######
# .# #####
#.$  $ $ #
# $    ..#
##########