##########
###@######
#     .  #
##$ #  $.#
#  ###   #
#  ####$##
#     . ##
#   #.$ ##
#   ######
##########