##########
####    .#
## @###  #
# .     .#
# $ $ .$ #
##### #$ #
#######  #
######## #
##########
##########