##########
###.  ####
### $$ ###
###   ####
####$ ####
####  ####
#### .  ##
##  #  $ #
#.   @.  #
##########