##########
##########
##########
##########
##########
#   #  # #
# .$ . $@#
# $ # .$ #
# .    ###
##########