##########
####  ####
##  $    #
### . $  #
# #####  #
#.###### #
# #####@.#
#$ # ##$ #
#.       #
##########