##########
### . .  #
####   $ #
####   ###
####  ####
#####  ###
# ## .# ##
#@$ $$   #
# .   #  #
##########