##########
##########
##########
###  ### #
###@$.   #
####$$   #
###  ###.#
#  $  .. #
#     ## #
##########