##########
#  #### ##
# $#@##  #
# . $. .##
# $ . $ ##
#  #######
# ########
# ########
# ########
##########