##########
###   .  #
###  . $ #
#### ## ##
#### $ .##
####     #
####### ##
#    # $##
#   .  $@#
##########