##########
#@$   .. #
# $ $ $  #
######.  #
#######. #
######## #
######   #
######   #
##########
##########