##########
#.  ######
#  $ #####
#   ######
#  $######
#.  ######
##.$######
#@ $ #####
# .   ####
##########