##########
##########
##########
##########
#####. ###
##### $ ##
##### . ##
# $  .$$ #
#@   .   #
##########