##########
## . .@  #
## $.#   #
### ### .#
# #  # $ #
#   ###  #
#    #####
# $$######
#   ######
##########