##########
##########
##########
######## #
######## #
## # ##. #
## $. $$ #
#   .. $ #
#     # @#
##########