##########
#  .  ####
# ..$ ####
#  #   ###
#$$#######
#@ #######
#.$#######
#  #######
# ########
##########