##########
##########
##########
#.########
# ########
#   ######
#@$$$  ###
#$  . .###
# . ######
##########