##########
# .  #####
#  # #####
#  #######
#.   #####
# $.######
#   . $@##
## $$ ####
#    #####
##########