##########
#  ###  .#
#   .    #
#  . $ $ #
#   #### #
# $#### .#
##  ###  #
##@## $  #
#####    #
##########