##########
##.    ###
##    $.##
##  .   ##
### ## ###
### #  # #
### $ @  #
#### $.$ #
####    ##
##########