##########
##########
###@######
#  $   ###
#.   $ ###
#.### ####
#  #. ####
#  #$$####
#.      ##
##########