##########
##########
##########
##########
##########
### @##  #
# $$$# $ #
#    #   #
##  .... #
##########