##########
#  #######
#  #######
#  #######
# ########
#.########
#      $ #
# $ ..$$ #
#.####  @#
##########