##########
#  . .   #
# $ $. $ #
# .#######
#   ######
#  #######
##  ######
#@$ ######
#  #######
##########