##########
# ..  ####
#  .  ####
## $ #####
##   #####
###$  ####
## $ #####
##@$.#####
###    ###
##########