##########
###      #
# $ $ $  #
#    ##.##
# ########
#@########
#. #######
# $#    ##
#.     .##
##########