##########
######.  #
#.     $ #
#      $ #
# ########
# ########
#  #######
#.$   $@ #
#      .##
##########