##########
####.   ##
###  $  ##
#### #####
#### #####
####.$ ###
###@$.   #
####  .$ #
####   ###
##########