##########
######   #
# $  .   #
# $$ $ ###
# .#######
#   ######
# @ ######
##  ######
# .    . #
##########