##########
######  ##
###     ##
###$$$ ###
### $  ###
##   #  ##
###.## ###
##      ##
#@.  . .##
##########