##########
###  #####
### $#####
###. .####
###   #  #
###  # $ #
###.  @  #
###.$  $ #
####     #
##########