##########
#.. $ . ##
# #  $$ ##
#  $    ##
### ### ##
######   #
###### .##
#### #  @#
####     #
##########