##########
#  #######
#  ## ####
# ##...  #
#  # $ ###
# ##  ####
# ## $####
#  # $ ###
# .    $@#
##########