##########
###     ##
####$  $@#
### . #.##
#  # .$  #
# ## #$  #
# ####  ##
#  #### ##
#      . #
##########