##########
## #######
#    #####
#  $@#####
# ########
# ########
# . $ ####
#.. $ ####
# $.  ####
##########