##########
######  ##
# ####   #
# #####. #
# ####  ##
# ####  .#
# ###   ##
#   #$$$##
#. $@  . #
##########