##########
# #### ###
# .   .###
# $    ###
# @ #  ###
# $##$ $ #
#   # .  #
# #### . #
######## #
##########