##########
########.#
#######  #
#######$ #
#######  #
# #####  #
#  .$ .  #
# $ ###$@#
#  . ##  #
##########