##########
######  ##
# $ $.   #
#  @  #  #
# #### .##
#$ ###  .#
# #### $##
#  ###   #
#.########
##########