##########
##### .  #
#####.# .#
#####  $$#
##### $  #
#######$.#
####    @#
#####  ###
##########
##########