##########
#   .  ###
# .$  ####
# #@######
#.# ######
# $ ######
#  .######
# $$######
#   ######
##########