##########
##########
##########
##@ ######
###$ ### #
##. #### #
##$  #   #
#  $ #$  #
# . .   .#
##########