##########
#.       #
#    $.$ #
# ###### #
# ###### #
#  ##### #
#  $@### #
#. $ #####
## .######
##########