##########
##########
##########
######## #
# ### # .#
#@.$  $  #
# $##   .#
# $      #
##    ##.#
##########