##########
#   ######
#.  ######
#$$ ######
#  #######
#..#######
#.  ######
#$$#######
#@ #######
##########