##########
# ########
# .## ####
#     $@##
# . $$ ###
#  ##   ##
#  # #. ##
# .# $ ###
# ##   ###
##########