##########
#  .  .@ #
# $ . #$ #
#######  #
#######  #
#######$ #
######   #
#### .$ ##
####    ##
##########