##########
# . .#####
# .$ #####
# #  #####
# $$######
#   ######
# ########
#  @######
# $  .  ##
##########