##########
##########
##########
#######  #
#######$ #
####  $ .#
# ###..$@#
# # # $# #
#.       #
##########