##########
##########
##########
##########
####. ####
#@.$. ####
# $   ####
# $$######
# . ######
##########