##########
####   ..#
#### $ $ #
#### .# ##
#### $ ###
#### @ ###
#### $ ###
#### . ###
###     ##
##########