##########
#######  #
#######$ #
#. ####  #
#        #
#.    #@ #
### #$  .#
### # $$ #
##### .  #
##########