##########
##########
# ##. ####
#     ####
#  #  #  #
#@.#. $ ##
# $## $ ##
#  .  $ ##
#       ##
##########