##########
###.  @###
### $  ###
#### . ###
#### . ###
### .#  ##
# $    ###
# $  $ ###
#       ##
##########