##########
##########
##########
####  ####
### @#####
### $ #.##
### .##  #
### $ $  #
### $  ..#
##########