##########
##########
#######  #
######## #
#######  #
#  ##### #
# $  $  @#
# $ .$...#
#        #
##########