##########
#        #
#     $  #
#   ######
# ########
#  # # ###
#   . .$ #
#.#    $@#
######.$ #
##########