##########
###  .  ##
# # #$ ###
# @  $  ##
#.   #  ##
#.     ###
# ###$$###
# ###  # #
#   .    #
##########