##########
#######  #
#######  #
######## #
#######  #
## #    .#
## #.$ ###
#@$ $$.###
#    . ###
##########