##########
##########
##########
# # ######
#.    ####
# . . #.##
#  ## $ ##
##$  $$ ##
##     @##
##########