##########
#  .   . #
# $ $  $.#
# ### #$ #
#@#####  #
#######. #
#######  #
##########
##########
##########