##########
#   ######
# $@######
#. #######
##$ ######
## $######
# .$ #####
#      # #
##.     .#
##########