##########
#   ######
# $. #####
#.$#######
#.  ######
#  .######
# $  #####
#$ #######
#@########
##########