##########
##. ##  .#
##    $  #
##  #.$ .#
#######$ #
#######  #
######## #
#######@$#
#######  #
##########