##########
######  ##
#####.  ##
#  ##   ##
# .$. .###
#    $$ ##
######  ##
##### $ ##
##### @ ##
##########