##########
##.##### #
## # ##  #
#@$      #
# $  # . #
## #######
# $ ######
# .$######
#   .  ###
##########