##########
###  .   #
###   #@ #
### $##  #
### .### #
### $## .#
#### ##  #
##  $  $.#
#        #
##########