##########
# .#######
#    .  ##
#  .   # #
# ### # @#
# $ $$ $ #
#      .##
# ########
# ########
##########