##########
###.######
###  . ###
###$#   ##
##  #  ###
# $ # $@##
#   #  ###
# $ .#####
# .  #####
##########