##########
#@########
#$ #######
# ########
#  # #####
# $#.#####
#    #####
# #.$   ##
#.#  $. ##
##########