##########
# .  .   #
#@$ $ $. #
#$ #######
#. #######
#  #######
##########
##########
##########
##########