##########
# ########
# . ######
# $#######
#  #######
# ########
# ### #.@#
# $ .$ $ #
#.       #
##########