##########
###### $.#
###### $ #
######. .#
#######  #
#######$ #
#######.$#
########@#
##########
##########