##########
##########
##########
#####   ##
#####.$  #
#####.. ##
###@  $###
####.$$  #
####    ##
##########