##########
##########
##########
##########
##########
#  . #####
# .$$  $ #
#  .  $.@#
###### # #
##########