##########
#@$ ..   #
## $   $$#
######. .#
#######  #
##########
##########
##########
##########
##########