##########
## #######
# .      #
##  #  $@#
#.  ###  #
# $###.# #
#  ###$# #
## ##    #
#####. $ #
##########