##########
##########
## #######
#.   .####
# $$ #####
# @#######
# # ######
# $.$ ####
#.    ####
##########