##########
##########
##########
##########
####. ####
####.$.###
#### $. ##
#  # $$ ##
#      @ #
##########