##########
##########
##########
##########
##########
##########
###   ####
# $@$$.. #
# .   .$ #
##########