##########
#  #######
#   ######
# $ .#####
#@  ######
# $.######
#   .#####
# ##   $ #
#  $ .   #
##########