##########
####..   #
#### $ $ #
#### ##  #
###  ##  #
###   #  #
### . #@ #
#### $ $.#
###   #  #
##########