##########
####.   ##
#### $ $##
######   #
## ### $ #
##.###   #
##  ### .#
# $####  #
#.      @#
##########