##########
# ...    #
# $  $.$ #
#  #######
#  #######
#  #######
## #######
# $#######
#    @   #
##########