##########
##   .   #
####  #  #
#######  #
#######$ #
#######@ #
### #.#$ #
#.     $ #
#   .$   #
##########