##########
#        #
##   $.$ #
##  #### #
### ###..#
## $### .#
###@##   #
###### $ #
#######  #
##########