##########
##########
# ########
# ########
#  ### ###
# .@$   .#
# $$ # $ #
#  ##### #
#    .  .#
##########