##########
##########
##########
### ##@###
#     $  #
# $ #  $ #
# .####  #
# ##  #$ #
#...     #
##########