##########
#   .    #
#     # $#
#  #####.#
##  ######
#.$ ##   #
#  @## $ #
# $ ###  #
# .      #
##########