##########
##########
##########
##########
####### ##
## #### ##
## $. . ##
##. $$ $@#
#  .    ##
##########