##########
##########
##########
#######@##
###.  $$##
####  $.##
######  ##
### $ .  #
#   .    #
##########