##########
##########
##########
###  #####
## $ #####
##. .#####
##. ######
# $$$ .###
#    @   #
##########