##########
# ########
# ########
#  #######
#  #######
# #####  #
#..#### $#
#$$  ## .#
#@$  .   #
##########