##########
#  #######
# $@######
# .$  ####
# $   ####
### . ####
###$ #####
###   ####
#   ..  ##
##########