##########
#     ####
#     ####
#.# .#####
# #.  ####
# # $#####
#  #@#####
# $$$#   #
#   .   ##
##########