##########
## ###   #
#   ..   #
#.$ #   ##
#  ##  ###
#  ##.  ##
# $##   ##
#  ##$$###
# ###@ ###
##########