##########
# ########
#.########
#    . ###
# $ #$. ##
# ###@$###
#  $    ##
## .   ###
##########
##########