##########
######## #
#######  #
#######  #
#######.$#
###### $.#
##### $ .#
#####@$. #
######   #
##########