##########
#   .   ##
#  # $.$##
# $###@.##
# $      #
# #  # . #
##########
##########
##########
##########