##########
##########
##########
# #    #.#
# $$$. . #
# $ . @  #
# ###### #
#  ####  #
#        #
##########