##########
##########
##########
##########
####@### #
####$ .  #
###.  $  #
### $##$.#
#      . #
##########