##########
###  #####
# @$ #####
#$$  #####
#. #.#####
# .#.#####
# ##  ####
#  #$  ###
# #     ##
##########