##########
##@ ######
# $#######
#$ #######
#  #######
#  #######
#..$ #####
# $..#####
#    #####
##########