##########
#  #####@#
#  #### $#
#.#####$ #
#  #### .#
#  #### $#
#  ####  #
# $ ###  #
#    .  .#
##########