##########
##########
#####. ###
####   $ #
####   $@#
####.  ###
## # $####
# $  .   #
#   .#  ##
##########