##########
##########
##########
#  #######
#@########
# ########
#  #####.#
# $ .$ $$#
#   . .  #
##########