##########
#        #
#.$.$# @##
# .$$.# ##
#     ####
# ########
# ########
##########
##########
##########