##########
##########
##########
##########
#######  #
#####  $ #
### ##$. #
#@$  .  .#
# $ .#   #
##########