##########
######## #
### ###. #
### ###  #
### @##  #
### ## $ #
### $ .  #
### $. $ #
#######. #
##########