##########
####  .###
###@$ ####
####$$ .##
###  # $##
###  #   #
#### ##  #
##   #.  #
#     .  #
##########