##########
#  #######
# $ ######
# $.$  @##
# ..  ####
#  .######
#  #######
# $#######
#  #######
##########