##########
#. #######
#  #######
#  #######
# ## #####
#  $   $ #
#  . $.$ #
# #####@ #
#.########
##########