##########
###    . #
##  $    #
## $. #$ #
###   .  #
##  ##   #
###$####.#
##   ##@ #
##       #
##########