##########
##   . ###
# .$   ###
##  #  ###
##    ####
#  #$  ###
#  # $@###
#.$ . ####
#      ###
##########