##########
####  @###
#####$$ ##
##       #
###.  . ##
#.    ####
# .$$ ####
#   ######
##########
##########