##########
#######  #
####### .#
#### . $ #
#### $.$ #
#####  . #
#######$ #
#######@##
##########
##########