##########
###     ##
# $ .$ ###
#. #    ##
# ## $####
#. . $@###
#     ####
# ### ####
# ########
##########