##########
##########
##########
##########
#####    #
#### $$# #
####@$.. #
#     #$ #
#   .   .#
##########