##########
######  ##
#####  ###
#####  # #
#####    #
######## #
### .# . #
# $ $  $ #
#.  .  $@#
##########