##########
## .   . #
### #   ##
#####.$###
####   ###
#####$####
####  #@##
####  $$ #
####  .  #
##########