##########
#  .   ..#
# $$$    #
## . ##$@#
## ####  #
######## #
#######  #
######## #
##########
##########