##########
###     ##
## #$$ $@#
##     ###
# .  #####
#    #####
#. # #####
#  .$ ####
# .   ####
##########