##########
# ########
# .#  ####
#@$.$. ###
# $ $ .###
# ##  ####
#  #   ###
# ########
# ########
##########