##########
#        #
#    $$$ #
#.###  @.#
# #  #####
#.$  #####
#     ####
###  #####
####.#####
##########