##########
##.  @####
## $$ ####
##. .#####
## $######
##.  #####
## $ #####
###  #####
##   #####
##########