##########
### .. $@#
###$ $$ ##
###     ##
###  #####
###.  ####
####  ####
### .#####
###  #####
##########