##########
######   #
######.$.#
###  ## @#
###  .$  #
####  #$ #
#### ## .#
#######$ #
#######  #
##########