##########
##       #
##.. .$$ #
##  ###@##
## ####$##
##  ##  ##
##  ##  ##
# $###  ##
##     . #
##########