##########
######  ##
####.$.$@#
####    ##
## . ##  #
# $    . #
#        #
###    $ #
#####    #
##########