##########
##########
######## #
######## #
# $ .    #
# .. $ $@#
# #####  #
#. ####$ #
# #####  #
##########