##########
#.   .  ##
# $  $@###
# ###  ###
# ####$###
#  ##.  ##
# ###  ###
#  ##$ ###
#      .##
##########