##########
# ########
#  # #####
#. $.#####
# $   ####
# .#.#####
#  @ #####
#$ $######
#   ######
##########