##########
##########
##########
### @#####
# #$$#####
#    ##  #
# $# ##$ #
#  #.##. #
#  . .   #
##########