##########
#######@.#
#######$ #
####### .#
#######$ #
##.  .   #
### # $  #
#######$ #
#######  #
##########