##########
#    .. .#
# #  $   #
####### .#
####### $#
#######  #
#######$ #
####### $#
########@#
##########