##########
#        #
# $$# $ .#
# # #### #
#  $ #####
#.   #####
#@  ######
# . ######
#.  ######
##########