##########
###   ####
###   .#.#
### $    #
### $  #.#
#### $#  #
####$    #
####@# . #
##########
##########