##########
#  #######
#.$#######
# . .#####
# .$ #####
# $  #####
#  #######
#$########
#@########
##########