##########
##  @    #
## $# $$ #
##. ##  ##
#  $.   ##
#  .#   ##
# ########
# ########
#.########
##########