##########
#### #####
# .. #####
# .$ #####
#@$$ #####
#   ######
# #. #####
#  $ #####
#    #####
##########