##########
#######  #
#######$.#
#  #### @#
#   ###$ #
# $ ###.$#
# .####  #
#  ####  #
# .      #
##########