##########
#    .   #
# $ $  . #
###  ### #
######## #
#### ##  #
### $  $ #
###. .  @#
##########
##########