##########
#.   .  ##
# $$ . ###
## .$$####
##  #@####
### ######
##########
##########
##########
##########