##########
#####   .#
###@## $ #
###$ ##  #
##  $ ##.#
##   ### #
###  ##  #
## .$   .#
#        #
##########