##########
##  .   ##
##   #.$##
##  ##  ##
##  #   ##
##@ #.  ##
##  ##$ ##
### $  $ #
####    .#
##########