##########
###.    .#
####     #
######  ##
######  ##
## $ . ###
# $ ## ###
# $ # $  #
#@    .  #
##########