##########
##########
##########
##########
####### ##
# ##### ##
#@$ .#. ##
#.$   $$ #
### .    #
##########