##########
##     ###
##  #.$###
#   #  ###
#.  #.$ ##
#     $@##
#    #####
#  $ #####
#.  ######
##########