##########
##########
#######  #
#######  #
######## #
## #### .#
# $ .. $ #
#@.$$ #  #
##  #    #
##########