##########
##########
##########
##########
######## #
######## #
### .##  #
# $ $.$$ #
#  .   @.#
##########