##########
##########
##########
##   # .##
#@$  $ $ #
##    $ ##
####.##  #
#### #.  #
### .    #
##########