##########
#######  #
####.  $ #
####   $ #
#######  #
####.    #
#### . ###
###@$ $  #
####    .#
##########