##########
#   ######
# . $ .###
#     ####
## #######
#  #######
#        #
##$# $#$@#
##.  .  ##
##########