##########
##########
#####   ##
#.   $$ ##
#      @##
#..   $ ##
#.$###   #
#   ### ##
# ########
##########