##########
#      ###
# . $ ####
# $#######
#  @######
#.$#######
#. #######
#$ #######
# .#######
##########