##########
##########
##########
######@ ##
#######$ #
##  ##  $#
## . #$. #
###$#  ..#
##       #
##########