##########
# ########
#  #######
#  #######
# .#######
# .#######
#  ##.  ##
#@$$  $ ##
# $ .  ###
##########