##########
#  # #####
# $. #####
# $$  ####
#  #   ###
# ##.. ###
# ###  ###
#  # $####
#.   @ ###
##########