##########
#  ### ###
# .  $ $ #
# .#@$   #
# .##### #
# $##### #
#  ####  #
# #####  #
#       .#
##########