##########
##########
##########
##########
##########
# . #@##.#
#    $   #
#.$$.  $ #
#  #######
##########