##########
#. #  ####
# $     ##
# ##  $ ##
#.   #####
# #$  ####
###  #####
#.  $@.###
##  ######
##########