##########
##       #
###  .   #
####  ####
# $ $  ###
#  @.#####
### ##..##
##  ##$$ #
##       #
##########