##########
####### .#
#######  #
######## #
##@##### #
# $  ### #
#   ###. #
# $ $  . #
# #  . $ #
##########