##########
#  #######
# ########
# .#######
#. #######
# $  #####
#$$.$@####
#    #####
#. #   ###
##########