##########
#  ##   ##
# $## $ ##
#   .$@###
# . .# ###
#. #######
#  #######
# $#######
#  #######
##########