##########
###      #
###.$$ $ #
##  .. ###
##. $#####
###@ #####
##########
##########
##########
##########