##########
#  #######
#.$##  # #
# .$   . #
# @##    #
# ##### .#
#######  #
## $   $ #
##   #   #
##########