##########
#    .####
#   $ ####
# .#######
# $#  ####
#.$   ####
#$#.  ####
#@########
##########
##########