##########
###   .  #
####@ #. #
#### #.  #
###  .$$ #
#### $   #
#### $## #
##    ####
#### #####
##########