##########
#    ### #
#$$. @## #
#  # ### #
#. # #   #
#. $ #   #
#  ####  #
#.$# ##  #
#        #
##########