##########
#      ###
# $ $ ####
#.##  ####
# ###@####
#. # #####
# $$ #####
#    #####
# ..    ##
##########