##########
##########
##########
#######  #
#### ##  #
####   # #
### $  $ #
### @# $.#
##. $  ..#
##########