##########
###      #
#####@$ ##
######$ ##
######  ##
#######. #
### .## $#
####$## .#
##   .   #
##########