##########
#   .    #
#  ..$ $ #
## #$.####
## #  ####
#   ######
#   ######
# $#######
##@#######
##########