##########
# #@# .###
#  $.  . #
# $ $$   #
#  # .   #
# ########
##########
##########
##########
##########