##########
##########
####### ##
####### ##
#  ###  ##
#$ ###$  #
#. ###. ##
#.$ ## $@#
#    .  ##
##########