##########
#        #
#    $$$.#
#  ##@$ .#
# .### . #
#  #######
##########
##########
##########
##########