##########
## # #####
##    ## #
##    #  #
###. ##  #
###  ## $#
####$.#$ #
###@$    #
####. ##.#
##########