##########
#######@##
### # #$ #
### $    #
##  $ #. #
##  ###$ #
##  ###  #
##   #   #
## . . . #
##########