##########
##########
# @  #####
# $ $#####
#### #####
###.  ####
###. #####
#.  $ $ ##
#      . #
##########