##########
#  .    .#
#    #@  #
#  ##### #
#  ##### #
#  .#.# ##
##    $ ##
# $#$ $ ##
#       ##
##########