##########
##########
##########
####### ##
##### #.##
#####   .#
#####.   #
#### $$$ #
##@$ .   #
##########