##########
#  . .. ##
#.    $ ##
####  $###
#####   ##
####@#  ##
#### $$ ##
####   ###
##########
##########