##########
##### ####
####  ####
####$ .###
###   ####
# #.  ####
#. #$ ####
#$ #.$####
#   @ ####
##########