##########
#   ######
# $.######
# $#######
#  #######
#..#######
# $ ######
#$@#######
# .#######
##########