##########
#       .#
#  $ $ $ #
#. ####  #
#  ####@$#
##.####. #
## #######
##########
##########
##########