##########
##########
##########
#. ### ###
#  .   $ #
# .# $  @#
# ####$  #
# ####.$ #
#       ##
##########