##########
####### .#
#### .   #
####   $ #
#####  # #
#### $## #
####$ #  #
####..$  #
#####@ # #
##########