##########
###### ###
#### .   #
####  $. #
#     #  #
# $#  ## #
#  #  # .#
# $ $ #@ #
#  #.    #
##########