##########
######   #
#####@$. #
#####. $##
##### $  #
# ####.$ #
# ####   #
#  # ##  #
#.       #
##########