##########
#.$. @ . #
#     $ ##
# $#######
#. #######
# $#######
#  #######
# ########
#  #######
##########