##########
#######  #
#  #### .#
#     ## #
# . .$@$ #
#  ## $$ #
#  ####  #
#.###### #
#        #
##########