##########
####@ .  #
#### $ $ #
###  .#  #
#### ##$ #
###  .#  #
###  ##$ #
### .##  #
######## #
##########