##########
####     #
####     #
###  ### #
####  @  #
#### .$$ #
#### $ # #
#####$ . #
##### .. #
##########