##########
##########
### ######
##  ######
##@  #####
###..$   #
##  $ $$ #
### #.   #
###### . #
##########