##########
##########
##########
##########
#  .######
#@$ ######
# $. #####
# $#######
#.$.  ####
##########