##########
##########
##########
##########
##########
##########
##@#     #
# $$.$$. #
# .     .#
##########