##########
#@       #
#   . . .#
# ### ## #
#  #  ## #
# $# $ # #
# .$$ #  #
#     #  #
##########
##########