##########
###### ###
###      #
### $ .  #
###   ## #
### $##  #
### .##$ #
##@#$ #  #
#     . .#
##########