##########
### .    #
###  # #@#
#####  $ #
#####. . #
##### $. #
#####    #
######$$ #
####     #
##########