##########
#@    ..##
#$$ $ $ ##
#. #######
# ########
#  #######
#   ######
# ########
#. #######
##########