##########
##########
##########
#.  ######
# .$######
# . $ ####
#     ####
#  #$$@###
# .    ###
##########