##########
#  . $  ##
# .$   ###
#@ ##.  ##
#  #######
#.$ ######
#   ######
# $#######
#  #######
##########