##########
##########
####@#####
### $### #
# $.  ##.#
#    ##  #
### $ #  #
### $..  #
###      #
##########