##########
####.    #
####   $ #
#### $#$ #
##### #  #
#@$    # #
##  . ####
####  . ##
####.    #
##########