##########
# ##. .###
# @    ###
#  #   ###
# ##   ###
#    $  ##
# .$ #  ##
# $$ #####
#   .#####
##########