##########
##########
##########
##########
##########
##########
####. $  #
### $  $ #
###@$... #
##########