##########
##      .#
#  $  $ .#
##  ###  #
# @ ###  #
#  ##### #
# ###### #
#. $   $ #
#. #     #
##########