##########
##########
##########
##  #### #
#   #### #
# $#@#   #
#   $$.$ #
#. #.  . #
# #####  #
##########