##########
###      #
## $$  . #
##  #### #
##  #### #
##  #@$ .#
##. ##   #
#  . $ ###
#      ###
##########