##########
#       ##
#  $ $ $ #
#.# .##  #
##  ###  #
##   ## ##
##. ##  ##
##.  ##$##
##     @ #
##########