##########
##########
## #   .##
##@$ $$. #
## $     #
#####.####
###   ####
####  ####
####  .###
##########