##########
#        #
# .. #$  #
# #  #@  #
# #$$.   #
# .  ##$ #
#    ##  #
#######  #
##########
##########