##########
##   #####
### $#####
###  #####
## .. ####
##  . ####
###  #####
#@$ $#   #
##.    $ #
##########