##########
##########
##########
########.#
###@##.  #
###$## $ #
##  ##   #
##  #  $$#
##     ..#
##########