##########
###   .  #
#### $ #@#
#  # $####
# $ $ ####
#     ####
#.  ######
#.  ######
# .#######
##########