##########
###@  ####
###.$ ####
#### ## ##
###      #
###.  #$ #
#  .   $ #
#### $  .#
##########
##########