##########
####   .##
#### .$ ##
#####   ##
##### @ ##
#  ##$ ###
# $##   ##
#.  # $ ##
#.      ##
##########