##########
#######@ #
###### $##
#### $$  #
####   .##
#####  .##
##### .###
####  $###
#   .   ##
##########