##########
#        #
#@ $   $.#
#  ###  ##
# .#### ##
# #####  #
#..$ #   #
# $     ##
## #    ##
##########