##########
#@  ######
#.$ ######
# .# #####
#   $. $ #
# $    . #
##########
##########
##########
##########