##########
##########
##########
##########
#######  #
#######  #
#.#  # #.#
#    $ $$#
# $ .@.  #
##########