##########
##  @ ####
###$$$####
##.$ .####
##  #.####
###   ####
#####. # #
####     #
##       #
##########