##########
#  @ #####
#$ $ #####
#. $######
# #.######
# ########
#. $ #####
#    #####
#.  ######
##########