##########
# ########
# ########
# ########
#  #######
#.     $ #
#.# #  $ #
# $. ##$ #
# .     @#
##########