##########
#   ######
#  $   ###
# $  . ###
#.$#  ####
#. #  ####
# ### ####
#  ##$ ###
#  #.@ ###
##########