##########
##. .  $ #
#    . $ #
#  ##    #
## ## ## #
# $$ #####
#.@  #####
##########
##########
##########