##########
# .   .  #
#   # $$ #
#  # # ###
# $   $. #
#.  @   ##
# ########
##########
##########
##########