##########
##  ######
# .#######
# $ ######
#    #####
# .  .. @#
# $  $ $ #
####     #
##### ####
##########