##########
# ###  ###
#. ##  ###
#  .#. ###
# .## $###
#      $ #
# $    $@#
# #   ####
##########
##########