##########
#. #######
#. #######
# $#######
# $@######
# $ ######
# $#######
#..#######
# ########
##########