##########
######   #
#######$ #
#######  #
#######. #
#######$.#
######.. #
## #@#$$ #
##       #
##########