##########
# .  #####
# $ ###  #
# $   .  #
#  ## #$@#
# $####  #
#  #####.#
# ######.#
##########
##########