##########
# $.######
#. #######
#  #######
# ########
#  #######
#  # #####
#$ . $ $.#
#@       #
##########