##########
#   ######
##$ .#####
# . ######
#   ######
# $#######
# .##### #
# $ # $ .#
#      @ #
##########