##########
# @#######
#$$#######
#..  $ .##
# # $    #
#.#####  #
#  ####  #
#   ######
#   ######
##########