##########
##########
##########
##########
##########
##########
#.########
#   .$ $ #
#  $ $.@.#
##########