##########
#####    #
##  #.   #
##  #  $@#
### #  # #
##  ## # #
##$ ####.#
#  .## $ #
# .    $ #
##########