##########
#@..     #
# $ $ $$ #
######.. #
####### ##
##########
##########
##########
##########
##########