##########
#  #######
# ########
# ########
#. #######
# $#######
# .#######
#   $ .$@#
# .   $ ##
##########