##########
#        #
#  @   $ #
#.#####  #
#  ####  #
#.$  $ $ #
#  ..   ##
#   ######
# # ######
##########