##########
#####    #
##### .  #
#### $ $ #
####. .  #
#######$ #
#######  #
#######$.#
####### @#
##########