##########
# .#######
# $#######
#  #######
#  $@#####
# $ ######
# $ ######
# . ######
#..   ####
##########