##########
#      ###
#   $  ###
#. ##$. ##
#. ## $ ##
#  ### ###
#.###  ###
# # #  $@#
#       ##
##########