##########
## .$@####
# $ ..####
#  $$ ####
# .#  ####
# ########
#  #######
# ########
#  #######
##########