##########
#######  #
#######$@#
####### .#
#######$ #
#######  #
#######$ #
#.  $ .. #
#  ##    #
##########