##########
# .   .@##
# $ $.$  #
# ##    ##
# ########
#  ####  #
#  ####$ #
#    ##  #
# .      #
##########