##########
##.  #####
##   #####
## .$@####
###$ # # #
## . #   #
#        #
# $ $#  .#
#        #
##########