##########
# ..     #
#    $ $ #
#. ##### #
#  ##### #
## ####  #
##$ ###. #
##@### $ #
######   #
##########