##########
##########
# ########
# ########
#. #######
#   $ ####
# .# $@###
#$ $. ####
#  .  ####
##########