##########
##########
##########
##########
######## #
######   #
##### $$ #
####...$ #
####@$  .#
##########