##########
#.  .    #
#  $  $ ##
# ## #####
# $ . ####
# #   ####
# ##$#####
#.##@#####
# ########
##########