##########
#  . .  ##
# $  $ ###
# ###@  ##
# ####.###
#  ## .###
#  #    ##
# $$    ##
#      ###
##########