##########
##. ######
## $######
#.  ######
##.$######
#  .######
#   ######
# $$ #####
#     @  #
##########