##########
# . $.####
#  $ .####
# ##  ####
# ##  ####
# #  #####
# #$@#####
# $    ###
#   .#####
##########