##########
####  ####
#### $ ###
####. ####
# $.  ####
# $  .####
#  #######
# $ ######
#@  .#####
##########