##########
#   . ####
#  $  ####
#. #######
# ########
#  #######
#.####. ##
# $  $$@ #
#       ##
##########