##########
#######  #
#######$ #
####### .#
#######$@#
#####.  .#
#####  $ #
####### $#
#######. #
##########