##########
#       .#
# $. # $ #
#######..#
#######  #
####  ## #
#@$    $ #
#  #     #
##########
##########