##########
# .#######
#. .######
# $$ #####
# $  #####
# ## #####
#  $@ ####
#  .  ####
# ########
##########