##########
#######  #
##  $ .  #
##  ## . #
## ### $@#
#  ##  $ #
#      $ #
# .#.    #
##########
##########