##########
#. .  . .#
#  @ $ $ #
# $##### #
#  ####  #
#######  #
###### # #
###### $ #
#####    #
##########