##########
##########
##########
##########
#      .##
## .. $  #
# $$##  ##
# .  #$ ##
#  ## @###
##########