##########
#######. #
######   #
####### $#
#  #   $ #
#@$    . #
### $ ## #
#### .##.#
##########
##########