##########
#      @ #
# $#$ . ##
#..$     #
# ###   .#
###### $ #
######   #
#######  #
##########
##########