##########
##   #####
###$  ####
###@ #####
###$ #####
##. ######
##$  #####
#  $.# ###
# .  . ###
##########