##########
##########
##########
##########
######  ##
##@###$ ##
# $$. $ ##
# . # .. #
#        #
##########