##########
#  #######
#.$ ######
#. #######
#  #######
# $ ######
#  #######
#.$$. ####
#    @####
##########