##########
###.     #
#### # $ #
#@   ## ##
# $  # . #
# #$ #  ##
###  ##  #
###. ##$ #
##      .#
##########