##########
#        #
#  $  $$ #
# .# .$@##
# ###  ###
#  ##.  ##
#. ### ###
# ########
# ########
##########