##########
# .$   .##
# $ $$ ###
#@#. .####
# ########
##########
##########
##########
##########
##########