##########
#  @# ####
##$$. ####
#  #$  ###
#     ####
# $ #  ###
#  ##  ###
#. # . . #
#        #
##########