##########
#######. #
####   $ #
######  .#
######## #
##### #  #
#@$     $#
#.$ #  . #
#######  #
##########