##########
#######  #
#######$ #
#######. #
##### #  #
#####. . #
### #$ .@#
# $  $ # #
#        #
##########