##########
##########
## .######
#  $ #####
# $@######
# #### .##
#.#### $ #
#  ### $ #
#.       #
##########