##########
##  @    #
###   $$ #
#####$. ##
### #  ###
## $ .   #
##  . .###
##########
##########
##########