##########
#   $  . #
#@$ # $ .#
#      #$#
#  # .#  #
####### .#
######## #
#######  #
######## #
##########