##########
## #######
#@ #  #.##
#    .. ##
# $   $.##
# $## ####
#  #   ###
# $#  ####
#     ####
##########