##########
##########
##########
######@ ##
### ##$$.#
# $ $    #
#    #   #
# ####   #
#   ...  #
##########