##########
#     ####
#@$ $$ ###
#  #  $ ##
#### #  ##
#### # ###
##### .###
### #  .##
#.      .#
##########