##########
#     .  #
#   # $  #
#@ ####$.#
# #####  #
# ########
# #####.##
#  ####$##
# $     .#
##########