##########
#####    #
######@$ #
####### .#
####### .#
#######$ #
#.#.###  #
# $  $ # #
#        #
##########