##########
#  #     #
##       #
#     .  #
# ###    #
# ###$#$ #
#        #
#   # ## #
#   #    #
##########