##########
#    #   #
# #   #  #
#  #..   #
#        #
#        #
### #$ # #
# #     ##
#      ###
##########