##########
#  #  #  #
#       $#
#  $  ## #
#    ### #
#    ##  #
#    $   #
#    $   #
#   .    #
##########