##########
# #  ### #
#    ##  #
#      # #
## $     #
#     #  #
#     # ##
#      . #
# #      #
##########