##########
#        #
#      ###
# ## $.###
###      #
#    $   #
#   #    #
#  $#    #
#      # #
##########