##########
#    #####
# #$.#####
#     ####
#  # #####
# # .#####
# $ .#####
# @$$#####
#.   #####
##########