##########
#        #
#    .  ##
#. ###$ ##
# # #  . #
# $ ### .#
#   ###  #
# #####$$#
#######@ #
##########