##########
#####    #
##@ ###  #
## $ ### #
### $### #
##   ### #
##...##  #
##  $$ # #
## .     #
##########