##########
##      ##
##   $$ ##
###  .   #
####.# .##
## ###   #
## #### ##
# $@   $ #
# .      #
##########