##########
#@#### ###
#$#### ###
# #### ###
#  ##   ##
# $## $###
#  #   ###
#. #. $ ##
#  ..   ##
##########