##########
#  #######
#  # #####
#      $@#
##.. $ $ #
#   ###  #
## ##  ###
# .$   ###
#     .###
##########