##########
#.########
#  #######
# .  ## ##
# $   .$ #
#   # $. #
#######  #
# @### $ #
#        #
##########