##########
#. $.. $ #
# ##     #
# ###### #
# ##### @#
#  ####  #
#  ####  #
#$. $ #  #
#   #    #
##########