##########
# ########
# $  .####
#@##  ####
# $  #####
###  #####
### $#####
##..$ #  #
##  .    #
##########