##########
# $  ... #
#    #   #
###### $ #
#######  #
######.  #
###### $@#
######$  #
######  ##
##########