##########
##########
##########
##########
##########
##########
#######  #
# # $ $$.#
#.. .  $@#
##########