##########
#@.    $ #
# $##  . #
#    ##. #
#.# $ $  #
# # #    #
##########
##########
##########
##########