##########
#.       #
# $ $.$ .#
#######@ #
#######$ #
#######. #
#######  #
######## #
##########
##########