##########
##########
#######  #
#######$ #
####@$   #
#####.$$.#
##### #  #
##  # #  #
#  .    .#
##########