##########
###   @  #
###$$ $  #
##  #### #
#    ##  #
# ..  ## #
##  ###  #
#### ##$.#
##.      #
##########