##########
#  @ #####
# . ######
# $## ####
#  $ . ###
# .$   ###
# ## #####
#.# $ ####
#     ####
##########