##########
#.   #####
# $ .#####
# #   ####
# #  .####
# #$$#####
# #@.#####
# ##$#####
#      ###
##########