##########
##########
##########
#######  #
## @###  #
##$$.### #
## .$##  #
##.  ##$ #
#  .     #
##########