##########
#.     $.#
# $ .  $ #
# ####.  #
#  ## $###
# ####@###
# ########
#   ######
# ########
##########