##########
##########
##########
##   .  @#
###    $ #
#### $## #
####    .#
#####$$# #
#.      .#
##########