##########
######   #
######$$ #
###@ . . #
#### $  .#
####### ##
#######  #
###### $ #
####    .#
##########