##########
## ### @ #
##   ###$#
##   ##  #
#.#.###  #
#     #  #
# $  ##  #
# $ $ # .#
# .#     #
##########