##########
#######@ #
#######$$#
#######  #
#######. #
#######. #
#######$ #
### # $  #
#      ..#
##########