##########
#   .  $ #
# $    ..#
# .$#### #
# $@#### #
#  ##### #
#######  #
#######  #
#####    #
##########