##########
# .   $ .#
# $      #
######## #
#######  #
###.  $@.#
### $ #  #
###   ####
##########
##########