##########
##########
#      ###
#.  . $ ##
#  ##.. ##
#  ###$ ##
#  ## @###
# ## $$###
#      ###
##########