##########
##########
##########
#  #######
# .#######
#  #######
# $#######
# $ .$ $ #
#.  @  . #
##########