##########
#        #
## .$  . #
## .  $ ##
### #$ ###
###$# .###
###@######
##########
##########
##########