##########
#  .     #
# $.  #  #
#######$.#
#######  #
##### #  #
##### $@$#
#####  . #
##########
##########