##########
#        #
# . $$ . #
## .$@####
## $.#####
###  #####
##########
##########
##########
##########