##########
##########
##########
##########
####### .#
#######$ #
#######  #
## $ $.  #
#@$   .. #
##########