##########
##   .   #
##   .#$ #
###$###  #
# $     .#
#.    # @#
#### ##  #
#######$ #
#######  #
##########