##########
####### .#
#######$ #
#######  #
#######$ #
#######@ #
#  ###   #
# $##.$ .#
#.       #
##########