##########
###### .##
###### $ #
# ####. ##
#   ## $##
#  ###   #
#  ###.  #
#  ####$ #
#  .  $@##
##########