##########
#        #
# .$ $ ###
#  #######
# $#######
# .## ## #
# .      #
# #   $  #
##### @. #
##########