##########
##########
##########
##########
##########
# .@ ### #
# $ ###. #
# $ $. $ #
#   #.   #
##########