##########
## #######
#. #######
# $  $ ###
#  .   ###
# $ ######
# #  ##  #
## $#@#  #
##   .  .#
##########