##########
####  .  #
####. $$ #
####   # #
##### #  #
####  #  #
#  # $ # #
# $## ## #
# @  ..  #
##########