##########
###    . #
###.$ #  #
#### .## #
# ### ##@#
#  #   ###
#. ## ####
#$$ $    #
#        #
##########