##########
#   . .###
#  # $ ###
#.### ####
# ## . ###
# ##   ###
#$ ##  ###
#  ##$$ ##
#       @#
##########