##########
##########
##########
#####    #
#####..$ #
#####    #
###  ##  #
### $ .$ #
##@$ .   #
##########