##########
#    ..  #
##   .   #
#####  ###
######$###
####  $ ##
##@$   $ #
####    .#
##########
##########