##########
# ... ####
#       ##
#    # ###
#.$#######
#      ###
# $ $ ####
###  $@###
###   ####
##########