##########
# .    . #
#    # $##
# ####   #
# ####. @#
# . ##   #
#      $##
# $ $   ##
####    ##
##########