##########
#    #####
# $$######
# #  #####
#     ####
# $      #
##  @  $ #
#######. #
### .  ..#
##########