##########
#  ### ###
# $  $ . #
# $  .   #
# @#####.#
#####  . #
#####    #
## ## $  #
##       #
##########