##########
######## #
####### .#
#######$ #
#######. #
#######  #
#######$ #
### $ $. #
###  @  .#
##########