##########
#@ ##    #
#$$ #.$  #
#.  $ #  #
# .   # .#
#######  #
#######  #
##########
##########
##########