##########
##########
##########
##########
#####.####
##       #
##@ .$ $##
##.. #$$ #
#        #
##########