##########
#### #####
###    ###
### .$####
####  .###
####. ####
#### $## #
####$$ @ #
###     .#
##########