##########
#   .#####
#$ .######
#  # #####
# $    ###
# $. #####
#@ #######
# $#######
#.  ######
##########