##########
# $ .$ . #
#    $ # #
# ########
#@########
#  #######
# ########
#    #####
#.$ .#####
##########