##########
######## #
#####@#  #
####.$#  #
#      # #
#  #  ## #
####$$ $ #
####. .  #
####  .  #
##########