##########
#  #  ####
# $$ . ###
#  #  ####
# .#$$ ###
# ##  ####
# ### ####
#.###.####
#  @  ####
##########