##########
#. #######
# $#######
# ..######
#   ######
#  #######
#   ######
##$$ #####
#@$     .#
##########