##########
##########
##########
# ########
#    .####
# $ $ ####
#  $@#####
# ..$ ####
#  . #####
##########