##########
#  # # ###
# $.   . #
# $$ ..$ #
#@ #######
# ########
# ########
##########
##########
##########