##########
#   ######
# $ ######
#   ######
##.##    #
#@    $$ #
# $      #
####. ## #
### . .  #
##########