##########
#        #
###.$. $ #
#######$.#
#######  #
#######  #
#######. #
########$#
########@#
##########