##########
#### #   #
##@$ ..$ #
##.$   . #
### #  # #
## $######
##   #####
##   #####
###  #####
##########