##########
#      .##
# .$$.# ##
## $  ####
#### .####
####  ####
#### #####
####$#####
### @#####
##########