##########
# ..######
#   ######
#  . #####
# $$ #####
#  $######
#  .######
# $   ####
# @  #####
##########