##########
##########
##########
##########
# ########
# @#######
# $### # #
#   .$ $ #
# .$   ..#
##########