##########
####### @#
#  ####$$#
#$  ###. #
#. # ##  #
#   .   .#
## #  #$ #
#######  #
######## #
##########