##########
# @ ######
#.$ ######
#  #######
#.$  #####
# $ .#####
# $#######
#. #######
# ########
##########