##########
######. .#
######   #
#### #  @#
##      .#
#  $$ #  #
# $ $ #  #
#  ##### #
#  .     #
##########