##########
## .######
#@     $ #
## $ $   #
###      #
### #    #
#####$## #
####  .  #
####  . .#
##########