##########
#  #######
#  ###   #
#.####   #
#  . ### #
#   $$   #
# $  .$. #
# @  #####
##########
##########