##########
####.    #
##### $ $#
####   #.#
##### #  #
#     # .#
# $ . #  #
## $# # @#
###      #
##########