##########
#  ## #..#
#  $ $   #
# . .  $ #
#@$##### #
#  ##### #
# ########
# ########
#  #######
##########