##########
# $  .   #
# $ .$  ##
#  ###  ##
# ####  ##
#  ###. ##
#  ###   #
#@##### $#
# ####  .#
##########