##########
##  .  ###
##   .  ##
###    ###
### ######
##   ##  #
###$$$ . #
###@$.   #
######   #
##########