##########
# $   .###
# $    ###
# ####  ##
# ###   ##
#  ###.###
# # .$ ###
# @# # ###
# $.######
##########