##########
###.     #
### $ $$ #
### $. @##
###  # ###
### .#.###
###   ####
###  #####
#### #####
##########