##########
##    #  #
## $.    #
#####$ # #
## #  #. #
#   $   .#
#     #  #
#.$ ######
#  @######
##########