##########
##  .    #
###$ #.. #
### ##   #
# $ $ .$ #
#      @##
##########
##########
##########
##########