##########
##...    #
# $@# $  #
#   #  ###
# $## .###
#  #######
# $#######
#  #######
##########
##########