##########
#######  #
#######@ #
######## #
#######. #
#######$ #
# .  $.  #
## $ .#$ #
##  #    #
##########