##########
##########
##.   . ##
### $ .$##
######  ##
### $ .$ #
## @     #
### ######
###  #####
##########