##########
#   .#####
#   . ####
#  .. ####
# # $ ####
# # $#####
###   ####
###$$ ####
### @#####
##########