##########
#### ..$ #
####   $ #
####### .#
#######  #
#######$.#
#######  #
#### ##$@#
##       #
##########