##########
#     .  #
### $  $ #
#######. #
####### .#
####### $#
#######$.#
####### @#
##########
##########