##########
#   ######
# $  ##  #
# .$ ## @#
# #      #
# # #  $ #
#  ### # #
#    $   #
##   . ..#
##########