##########
######   #
# #    . #
# .      #
# $@### ##
# .$##  ##
##. ##  ##
##$ ## $##
##      ##
##########