##########
## .   ###
## $  .  #
##  ###  #
##  #### #
##$  ### #
##  ###  #
#   $.#$@#
# .      #
##########