##########
#######  #
###@$ .$ #
#### $#. #
## .     #
###  ##$ #
#######  #
#######. #
#######  #
##########