##########
# @      #
# .$ $ # #
### ###  #
# $   .$ #
# .  .   #
# ########
#  # #####
#       ##
##########