##########
##########
######@###
#. ## $  #
#   $   .#
#  # $ ###
#.#### ###
# # $.  ##
#        #
##########