##########
#####    #
###@$ $$ #
#### $   #
###### . #
#######  #
######  .#
######.  #
######  .#
##########