##########
#   ######
#  $#  ###
#.$.$ ####
#  # @####
#. #$ ####
#.##   ###
# ###  ###
#        #
##########