##########
##########
##.#######
#  @ #####
#$$#######
#  $ #####
#. # #####
# $.  ####
# .  #####
##########