##########
## ##### #
#. .     #
# $ $   .#
#  ##### #
# ###### #
#  # #####
# $ $ ####
#@ .  ####
##########