##########
###      #
##. $ $$.#
#        #
# $## ####
#   ######
#  #######
#   ######
#.@.  ####
##########