##########
####. .  #
###   #$ #
####$#@  #
#### #####
###  #####
## $ .####
# $  .####
#      ###
##########