##########
#       .#
#. # $.$ #
#   ###  #
#$  ### @#
# $ ###. #
#   ######
##########
##########
##########