##########
########@#
####### $#
#######$ #
#####   .#
#####.$  #
#######. #
#######$ #
####   . #
##########