##########
##########
##########
####  @###
####$$####
####  ####
#### . ###
## $$   ##
# . .. ###
##########