##########
#   ######
# ########
#. #######
#  #######
#  #######
# $##.   #
#   $$ $@#
#  #. .# #
##########