##########
# @      #
# $   .$ #
#  ###. ##
# ####.  #
# #### $##
######. ##
###### $##
######   #
##########