##########
##@#######
# $ ######
#  $######
#.. ######
# #.$ ####
#    .####
# #$  ####
#      ###
##########