##########
###### # #
# $.  .  #
# $ $ .# #
#   ###  #
#######  #
#        #
#$#     @#
#. #  ####
##########