##########
#   .#####
# $   ####
#  # #####
#.########
#  #####@#
#$ #    $#
# . $  #.#
#        #
##########