##########
#      ###
#  $ #$###
# ###  .##
#.  #. ###
# $ .$  ##
#  @   ###
# ########
# ########
##########