##########
#    @ ###
# $.$ $###
# ###  ###
# #### .##
#####   ##
######$  #
##### .. #
#####    #
##########