##########
# ########
#       @#
# # $   ##
# ##  ####
# # . ####
#.$$. ####
# $    .##
#####   ##
##########