##########
#        #
#  .   @ #
# ####  ##
# #####  #
#    ## ##
##. $ . ##
##.$$ $ ##
##     ###
##########