##########
###  #. ##
###  .  ##
###  #   #
###    $ #
###  #  .#
#    @# ##
# $$ # $##
#.      ##
##########