##########
##########
##########
#. #######
# $#######
# .#######
#   $@####
#.$$ #####
#  .######
##########