##########
#   ######
#$$ ######
# . ######
# .#######
#.$ ######
#   ######
##$.######
# @ ######
##########