##########
#.  ######
#@####  ##
#  ##   ##
#.### $ ##
# ### $ ##
#  ## $ ##
#.   $. ##
#   #  ###
##########