##########
#        #
# # .$ $.#
# #### $ #
#.##### ##
#   $@#.##
#   # ####
# ########
##########
##########