##########
#   @    #
#  ## # $#
#  ##### #
# #####. #
# ##   $ #
#####.# .#
####  $$ #
#####  . #
##########