##########
##     .##
## $.#  ##
######   #
#######  #
######   #
######$ .#
###@$    #
#### $ . #
##########