##########
#.  ######
#. $######
# $ ######
#   ######
# $  #####
#@  ######
#  $ #####
##. .    #
##########