##########
###    ###
### $ $@##
#### . ###
#####..###
#####   ##
###### ###
# $ $    #
#     .  #
##########