##########
#     .  #
#  $. $  #
##$#######
# $.######
#@.#######
## #######
##########
##########
##########