##########
##########
#######. #
####### $#
#######  #
#######  #
####### .#
### # $$.#
#@$     .#
##########