##########
##########
##########
######## #
########.#
##@#### $#
# $# ## .#
# .$ ## $#
#      . #
##########