##########
# ########
#  #######
# $@######
#.#$######
# $ ######
#.$.  ####
#  . #####
#   ######
##########