##########
## .     #
### $. $ #
#### ## @#
###  ###.#
###   #  #
#### $ $ #
####.# # #
###    ###
##########