##########
##       #
##    # @#
######## #
######## #
#  .  #  #
# $..    #
#  .$ $$ #
#######  #
##########