##########
###      #
#### $ .##
# $@$ .###
#  #   ###
# # ##.###
# $  .  ##
#     ####
# ########
##########