##########
####     #
#### $.  #
####     #
## #  .  #
#.   $ . #
# $$#    #
#@  ######
# ########
##########