##########
#        #
##.  $ # #
#####  ###
###### ###
# .  #  ##
#@  .$.###
# $$   ###
###    ###
##########