##########
#        #
## $ @ $ #
###   $  #
###.   # #
#####$## #
####   ..#
####   #.#
##########
##########