##########
###  $.  #
###@$   .#
#### ### #
######## #
#######  #
#   . #. #
# $  ##$ #
#        #
##########