##########
#  . #####
#    #####
# # $#####
# $    . #
#  . #   #
####  #$ #
####$ # .#
####@#####
##########