##########
# $  .   #
#@$.$ .$ #
######  .#
######## #
######## #
##########
##########
##########
##########