##########
####  ####
####   . #
#  ##    #
#       .#
#.$$@ #  #
##  $  ###
###.$ ####
###    ###
##########