##########
##########
######   #
### $ .$ #
### $$.. #
###@  ##.#
######## #
##########
##########
##########