##########
##  .    #
##. $ # $#
##@ ###  #
###  ## $#
##  ### .#
##  ### .#
###   #$ #
##      ##
##########