##########
#  #######
#  #######
# # .  ###
# $ .. $ #
#  . # $ #
#####  $@#
#####  ###
#####   ##
##########