##########
#### #   #
####  $. #
####. $. #
#####$.  #
##### $# #
######@###
##########
##########
##########