##########
#######  #
## . ##  #
## $ # . #
##@$  $. #
#### $  .#
######## #
######## #
##########
##########