##########
##########
##########
##  # .###
##  #$  ##
###    ###
###.##$@##
##   .$$ #
##  .    #
##########