##########
##########
##########
##########
###### . #
######$$ #
######@$ #
### # $. #
##  . .  #
##########