##########
##########
#######  #
#######$.#
####### .#
#######$@#
# # ###  #
#    # $ #
#.    .$ #
##########