##########
####@$. .#
##### $$ #
#####  . #
###### . #
####### $#
#######  #
##########
##########
##########