##########
####     #
# .$ . $ #
##     $ #
#  ### $ #
#  ###  .#
#   ###@##
#  #######
#     .  #
##########