##########
##########
##########
######## #
######## #
# ## ## .#
# .      #
# $$.##$$#
#.  ##  @#
##########