##########
##########
##########
# @ ######
#.#$######
#.$ .#####
#$  ######
# $ ######
#  .  ####
##########