##########
###  #####
###   ####
###  #####
# ..  $  #
# #      #
#    ### #
# .$ $@$ #
#.  ##   #
##########