##########
####### .#
####### $#
#######  #
####### .#
#######. #
####### $#
#######$ #
##@$    .#
##########