##########
#    .   #
# $  $.$ #
#@.#######
#  #######
# ########
#   ######
# $ ######
# .#######
##########