##########
###     ##
###.  $  #
#### #   #
### # #  #
###   $  #
##@$  #. #
## $ ## .#
###    . #
##########