##########
###    ###
###.  ####
### $ #. #
### . #  #
###$$##  #
###@ ##  #
####. #$ #
####     #
##########