##########
##########
####@ ####
# ##$ ####
# .   ####
#. $ #####
# ########
# $ . #  #
# $ .    #
##########