##########
#   ..  ##
# $ #..  #
#  ##  $##
# ####  ##
#  ###$$ #
#  ###@  #
# ###### #
#   ######
##########