##########
# ########
#.########
#  #######
# $#######
# .  $  ##
# $.@. ###
#$ ### ###
#  #######
##########