##########
#. $  . ##
# $      #
# #####  #
#$ ###. ##
# @###$. #
######  ##
####### ##
##########
##########