##########
#        #
#. $. $$ #
#######. #
#######  #
#  # ### #
# $     .#
# @#     #
##########
##########