##########
####### .#
#######. #
#######  #
####     #
#### . $ #
##### $$.#
######@$ #
#######  #
##########