##########
#  @######
#$$#######
#  .######
#.  ######
#  #######
#. #   ###
# $#$ ####
#.       #
##########