##########
##########
##########
#.###### #
#  ## ## #
# $   .. #
# # $$ $@#
#  ##.# ##
#        #
##########