##########
##########
###  #####
# $  ## ##
# .      #
## $  #.$#
#  ####$.#
#  # ##  #
#      @.#
##########