##########
##########
#   ## ###
##$ ##.  #
# $  $ $@#
#   # ...#
# #####  #
#   ###  #
#        #
##########