##########
# .  #####
#@$ $#####
#.$$ .####
# . ######
#  #######
# ########
# ########
##########
##########