##########
# @ .   ##
#$#  #$ ##
# $.##  ##
#   ### ##
# ########
#  #######
#.$ #   ##
#     . ##
##########