##########
#.    ####
#  .$  ###
#  #$ # ##
# ##  . ##
# @## $ ##
# #### .##
# ####$ ##
######   #
##########