##########
# .@     #
#    ... #
# $  ##$ #
#  ####  #
#### $ $ #
####     #
##########
##########
##########