##########
##       #
#@.  $ $ #
#    ##  #
######## #
##### .  #
####   $.#
##### $ .#
##########
##########