##########
#####.  ##
#####$ ###
#####.   #
###### $.#
##### .  #
#####  # #
## ###$#$#
##   @   #
##########