##########
#. .$@####
#  $. ####
# $#######
#  #######
# $#######
#  #######
#.########
##########
##########