##########
# . $ ####
#    .####
###  .####
###  #####
### $#####
###$  ####
###.$ ####
####@#####
##########