##########
#     # ##
#   .$   #
##.$  @$ #
#  ####. #
#   ###  #
#  ####$.#
#   ###  #
######## #
##########