##########
###    . #
##@$.  $ #
###$ ### #
## .#### #
#   .  $ #
#  ####  #
#   ######
##########
##########