##########
#. . #####
# $$.#####
# $  #####
#  #######
# .#######
#$ #######
#@########
##########
##########