##########
#### . $ #
###@.$$$ #
###    . #
#### ##  #
####.### #
#######  #
#######  #
##########
##########