##########
##########
##########
##########
##########
######@###
##.   $###
#.  $$. ##
# $   .  #
##########