##########
### . @###
###$$ ####
##   #####
### . ####
##. $#####
##    ####
##. $#####
##     ###
##########