##########
# ###    #
# ###$ ###
#.. #  $@#
# $    $ #
# .  # ###
#.########
##########
##########
##########