##########
#######  #
####. # ##
##@#     #
#.$$     #
# .$ #$ ##
#  #    .#
####     #
#######  #
##########