##########
### .. $.#
###    $@#
#### # $##
######  ##
#######$ #
######  ##
######  ##
######  .#
##########