##########
#####   .#
#####.$$ #
####### .#
#######$ #
#######  #
## ####  #
##@$ .   #
## ##    #
##########