##########
#        #
# $$ #   #
# .##    #
#.$@$    #
####    .#
######   #
###### . #
######  ##
##########