##########
# @    . #
#.    #$ #
##  ### $#
## .#### #
## $ ##  #
##  ##   #
##     $.#
##     # #
##########