##########
#.   .   #
#. $ $ $.#
#######  #
######## #
######## #
#######  #
####### $#
####### @#
##########