##########
#.    ####
# .  $@###
# ##$ ####
# ##  ####
#  ##  ###
# ##. ####
# $   ####
#. $    ##
##########