##########
#.  ######
# $ ######
#. ##### #
# .###   #
#   $    #
#$$.##   #
#@########
##########
##########