##########
##########
##########
####### @#
#######$ #
#######  #
## . $.. #
##   $#$ #
#####   .#
##########