##########
####@$.  #
#### $   #
######## #
#######  #
######.  #
###### $ #
#####  $.#
####  .  #
##########