##########
##########
# ########
#.  .#  ##
#    #@###
### #  .##
###$$$$ ##
###.   ###
#        #
##########