##########
##       #
# $.$    #
#  . ### #
# @####  #
# $##### #
#  #### .#
# ###### #
##### .$ #
##########