##########
# @##   .#
# $ .#. .#
# $$$    #
#        #
# ########
#  #######
#  #######
# ########
##########