##########
### @#####
##.$$#####
##    #. #
###.$ # $#
####    .#
######   #
#######  #
######## #
##########