##########
##########
##@####.##
# $####  #
#$ ###   #
# $      #
# .$  # .#
#  #######
#.########
##########