##########
####### .#
#######  #
######## #
### ###  #
#        #
#$$ $ #  #
#.  ###$ #
#. .### @#
##########