##########
#    #####
# . ######
# $#######
#  .$@####
# .$ #####
#   ######
#.$#######
#  #######
##########