##########
##########
##@###.# #
##$ .    #
#  #.  $ #
#   ###  #
#    . $ #
#      $ #
#  #######
##########