##########
##### ## #
# .    $ #
# $ $. $@#
#   ######
# .#######
#.########
# ########
#    #####
##########