##########
##     . #
## $.$.$ #
##$@###  #
## ##### #
#   ###  #
#  ####  #
# . ###  #
#        #
##########