##########
#  .$ ####
#.    . ##
#####  $ #
## ## .  #
# @    # #
##   $ ###
### $  ###
###   ####
##########