##########
# .  $.$ #
#   .$@$.#
# ###### #
#        #
# #    ###
##########
##########
##########
##########