##########
#####   @#
#######$$#
#######  #
#######$ #
#######  #
### ###  #
##   #  .#
#  . $. .#
##########