##########
###   ####
###$ #####
# .@ #####
#  $ #####
# ########
#.##  ####
# $   .###
#.$   ####
##########