##########
# #### . #
#.$ $ $. #
#    @$  #
# ########
#  #######
# ########
#.########
##########
##########