##########
#    ..  #
# $   #  #
##   ##$ #
##   ##  #
###.###$@#
#######. #
#######$ #
#######  #
##########