##########
#@########
#$     .##
#.$# #  ##
#  #######
#$ . #####
# $ ######
#  #######
#. #######
##########