##########
#   ## ###
#..  $ $@#
#      $ #
# ########
#.########
#  ##  ###
# $#   ###
# .   ####
##########