##########
##########
##########
##########
##########
####### .#
#######$ #
##  .$.$@#
#.     $ #
##########