##########
###  ###@#
####  # $#
#.     $ #
# $. #  .#
#######  #
#######  #
#######$.#
#######  #
##########