##########
#  . .####
#      ###
# $ $. ###
# $$ #####
# .#######
#  #######
# ########
#@ #######
##########