##########
####     #
#### $.$.#
##    .# #
#  ####  #
#  ####  #
##  #### #
## $### $#
#  @   . #
##########