##########
####@ ####
### $$####
#### .####
####  #  #
##  .   .#
###  $  .#
#######$ #
#######  #
##########