##########
#    #####
#    #####
# ########
# ########
#@$.######
# $$ #####
# ..$ ####
# .    ###
##########