##########
##########
##########
##########
##########
#   ## .##
#.@$ .   #
# $$ .$ ##
#     ####
##########