##########
##########
##########
##########
# ..   $ #
# $ .#   #
#######$ #
######   #
#@$    . #
##########