##########
# .      #
# $ # $$ #
# ####@ ##
#. ## #$ #
#  .   . #
# #      #
#  #######
# ########
##########