##########
#   #  ###
#   #  . #
# # # @  #
# ###  . #
#   ## ###
# $$   ###
#..$ $ ###
#   ######
##########