##########
##   ##  #
#.$      #
#     #$ #
# .#### .#
# $ $ #  #
#  @  #  #
########.#
##########
##########