##########
###     ##
#### $  ##
###### ###
######   #
####   .##
#### $#  #
#@$ .  .##
##   .$ ##
##########