##########
##########
##########
# #  #####
#  ..@####
# $$ #####
# .# $.###
# ##$  ###
#    #####
##########