##########
#   . ## #
### $## .#
###  ## .#
###   #  #
#### $   #
### $    #
###@$.#  #
####  ## #
##########