##########
##       #
##.    $ #
#   .#  ##
#  .###  #
# ####. ##
#  ###$$##
# ###  $@#
#       ##
##########