##########
###     ##
### ... ##
###$    ##
#   $$####
# .   ####
#  #######
##$#######
#  @ #####
##########