##########
#  .. ####
#  $.@####
# $ #  ###
##$ $.####
##    ####
##########
##########
##########
##########