##########
#        #
##     $ #
###.     #
###    . #
# $ # ####
# . ######
# $$######
##  @ .###
##########