##########
# ########
#  #######
# $#######
#  #######
#. #######
# $ ######
#$ . .# ##
#.     $@#
##########