##########
####.   .#
#####  # #
#####. $.#
##### $  #
#######  #
#######  #
#######$$#
#####  @ #
##########