##########
# .    ###
# $  $ ###
# ### ####
#  ##$ ###
# ###.  ##
# .   @###
# $  . ###
#  #######
##########