##########
#      ###
# $.$.$.##
#####   ##
###### ###
###### ###
#### # $ #
#### #  @#
####.    #
##########