##########
##########
##########
##########
##########
#####    #
#####$#$ #
####  . .#
#@$. . $ #
##########