##########
####.    #
## $     #
## $###  #
##   ### #
##   ##  #
##. ###. #
### # $  #
##@$   . #
##########