##########
#       @#
#.$$ #   #
# #. ##  #
#$  #### #
# $. ##  #
# . #### #
#   ######
##########
##########