##########
#@$.######
#$$   ####
# .#  ####
#. #######
#  #######
#$########
# ########
#.########
##########