##########
###     ##
### $ $ ##
######   #
######  ##
#######@ #
# .  # . #
# $ ##$ ##
#   .   .#
##########