##########
# $ .. $ #
# $.  .  #
# $#######
#  #######
# ########
#  #######
#@########
# ########
##########