##########
###  #####
#. . @####
# $ $ ####
# .#######
# $  #####
#   ######
# $  #####
# . ######
##########