##########
#####  ###
####  $ ##
####  .@##
#####$. ##
#####  ###
#####$ ###
####.$.###
####     #
##########