##########
##########
##########
##########
##########
#####. # #
#@$   $$ #
#..$    .#
#  ###   #
##########