##########
##       #
##.$  #  #
#   ### .#
#.  #### #
###$# $  #
##@ $    #
####    .#
###### # #
##########