##########
#    .####
# $  #####
###    ###
###  .$ ##
###@    .#
### .## $#
#### ##$ #
###      #
##########