##########
##### ####
####  ####
## $ .####
# @  .## #
#  #$ ## #
## #   $ #
#####..$ #
####     #
##########