##########
#.  ######
# $. #####
#   ######
#  $@#####
# # ### .#
##  ###  #
##. $ # $#
###      #
##########