##########
###   ####
#..    $ #
# $.  $@ #
#### #####
####  ####
### $ ####
####. ####
#### #####
##########