##########
# . .    #
# $    $ #
#   $ ####
#  @  #  #
##### ## #
#####  # #
###    $ #
#### .  .#
##########