##########
##########
##  #### #
## # ### #
#     #  #
# $ $$#$ #
# ..# #  #
## .  @ .#
###      #
##########