##########
##########
##########
#### #####
#    .####
#.$ @ ####
# #$### ##
#  $. $ ##
#       .#
##########