##########
##########
##########
##########
#####.  ##
#  . @$ ##
# $ # ####
#  # $ $ #
# .  .   #
##########