##########
##    .  #
##..     #
###  ### #
#    ### #
# $ # @  #
### $  $ #
###   $###
###    . #
##########