##########
#.  ######
# $ ######
#  #######
# $#######
# .  #####
#..$ #####
# $#######
# @#######
##########