##########
#### $.  #
###@$  . #
####..$$ #
####  #  #
###  ### #
###  ##  #
## ####  #
#        #
##########