##########
#######  #
###@#### #
###$  . .#
##  #    #
##$ ###$ #
##..###  #
##  ###$ #
#######  #
##########