##########
##########
##########
##########
####@$.###
#####$ ###
####  $###
## $ .. ##
#  .     #
##########