##########
#      .##
#  .   ###
#.  #. ###
#  #   ###
#  #$$####
#      ###
## $#$####
## @   ###
##########