##########
### .#####
## $  ####
# $   ####
#@$ . ####
####$#####
#### #####
##  . ####
#  .  ####
##########