##########
#  #######
#$ #######
# . ######
#. $######
# $. #####
#.  ######
# $#  ####
# @  #####
##########