##########
##########
##########
##########
### .#  ##
### $  @ #
### $$.$ #
### # #.##
###   .  #
##########