##########
##########
##########
##########
###.######
## $  ####
## $ #####
## . $.###
#   . $@##
##########