##########
######## #
#######  #
###### . #
### .@$  #
#  # $ $.#
# #####  #
#  ##### #
#.     $ #
##########