##########
##########
##########
####  ####
#### #####
###  .####
###$  #.##
#   $.#$##
# .    $@#
##########