##########
##########
## #######
#  #######
#.$ ######
# .$ #####
#$.   ####
# $@.# ###
#      ###
##########