##########
## . #####
###  #####
### . ####
###.$ ####
##@$.#####
###   ####
###$$ ####
###   ####
##########