##########
#######. #
###### . #
######.$ #
#####    #
##### $$ #
# @##  # #
#   #.$###
#        #
##########