##########
#      ###
## .$  ###
####  ####
####. ####
#### $  ##
## .#@# ##
#  $##  ##
#   . $ ##
##########