##########
##########
#######. #
#### #  ##
#. . #$ ##
#.     $@#
#     #  #
# $ $#####
#    #####
##########