##########
#     ####
## . #####
###$  ####
#    #####
#    $..@#
#  ## #  #
#######$ #
###  . $ #
##########