##########
# $   .  #
# .   @$ #
#.$##### #
#. ###   #
# ########
# ########
# $  ## ##
#       ##
##########