##########
#    .   #
# $  $.$ #
#..#######
# ########
# ########
# ########
#  $ #####
# @  #####
##########