##########
#    ## ##
# $ $ .$ #
# $..   .#
# ########
# ########
#@ #######
##########
##########
##########