##########
#   ######
# .$######
# $ #  ###
#   $  ###
#  @# ####
#   $.####
# .  .####
##########
##########