##########
# ########
#  #######
#..#######
# $$   ###
#    .####
# .#######
#$$#######
#@   #####
##########