##########
# ##### ##
#  .    .#
#  ##    #
#    #####
#.$ $@####
#. $ #####
# $#######
#  #######
##########