##########
##########
##########
##.####  #
# $    $ #
# $ #  . #
#  ##### #
#@#####  #
# .    $.#
##########