##########
#.   #####
#  $ #####
# . ######
#$.#######
# $#######
#  #######
#.$#######
# @#######
##########