##########
#   .  ###
#.   $ ###
# ### ####
#  ##  ###
#.$# $ ###
#   @ ####
## #$. ###
####  ####
##########