##########
###  . . #
###.   $ #
###  # ###
###    ###
#####$$###
#####   ##
#@### $###
#    .   #
##########