##########
#    #####
#   $#  ##
#.  @ $ ##
### .##  #
###. ##  #
####.##  #
## $  $ ##
#       ##
##########