##########
### ######
##  ######
#. $  ####
##   #####
### $ ####
###   ####
####$  ###
#@$ .  ..#
##########