##########
#  #######
#  #######
# . ######
#   @    #
#.. $  $ #
###  ##$ #
### $##  #
###  .   #
##########