##########
## #######
#   ######
#.$.######
#@$$######
#   ######
#.$#######
# . ######
#  #######
##########