##########
##########
##########
##########
##### ####
###      #
# .$$@$ ##
# . .##  #
# $    . #
##########