##########
##########
##########
# ########
# ##@##.##
# $ $ . ##
# $$ .#  #
#   ##  ##
#  .     #
##########