##########
##..$ ####
# $ $ ####
# $#.@####
# .    ###
## ## ####
#  ## ####
## #  #  #
####     #
##########