##########
##########
####### .#
######@$ #
###### $ #
####### $#
# # ###  #
#. .  $ .#
#   # #  #
##########