##########
####     #
####$$ $##
### $   ##
###   # ##
###   .  #
#### . # #
###  @## #
# .    . #
##########