##########
#      ###
#  $ #  ##
# ### .###
# ###  $@#
# ####  $#
# ####.$.#
#.####  ##
# ########
##########