##########
#    .   #
#@$ # $  #
# $####$.#
#  ####  #
#  #######
# ########
#.########
#.########
##########