##########
##########
######## #
# # ##@# #
# $   $. #
# # $.   #
#  ##### #
#   #    #
###  .$ .#
##########