##########
##### .  #
#####$.$ #
#####..$ #
###### $ #
#######  #
######## #
####### @#
#######  #
##########