##########
##########
#@ #######
#$$#######
# . ######
# $##### #
#.  ###  #
#  #   $ #
#  ..    #
##########