##########
#  #######
# $  $@###
#  .  ####
#  #  ####
# ##.$####
#  ## ####
# $##.## #
# .      #
##########