##########
#  #######
#  #######
# ########
# ########
#     ####
#..$ $@###
# $.$ ####
# # . ####
##########