##########
#  #######
#. #  ####
# $   ####
#   .#####
# ########
#  ##.# ##
#$$ .$   #
#   #@#  #
##########