##########
##########
##########
######   #
##  ###$ #
# $.  #  #
# $ .##  #
# $####  #
#..     @#
##########