##########
#### $.. #
####     #
#######$ #
#######@ #
######## #
####### .#
#. $ $   #
#        #
##########