##########
##########
##########
##########
##########
#####.#.##
#@.$     #
# $  $ $ #
#   .#####
##########