##########
#####    #
#####  $ #
# @####. #
# $####  #
#   ### ##
# $ $   .#
# # .  . #
##########
##########