##########
#..    ###
#      ###
####    ##
###  #   #
###  ##  #
####$ $ ##
###@$.$ .#
#####   ##
##########