##########
##########
## # ##@##
##  .  $ #
## $.$   #
### ######
#.  ######
# $  #####
#.   #####
##########