##########
##########
##########
########.#
####     #
#### $.$ #
####  ####
#### $. ##
#@$   .  #
##########