##########
##  ######
#.  ######
# $#######
#  ### . #
# .. $ $ #
#   #@$ ##
# ####  ##
#####   ##
##########