##########
#    @ .##
# $ $    #
######$$ #
######   #
#######  #
#######..#
#######  #
#######. #
##########