##########
#.########
#. #######
# $#######
#  #######
# $#######
#$ #######
#@$ ######
#.. ######
##########