##########
###    ###
### $ ####
#####.#  #
###  .##@#
### $ $. #
###  ##  #
###  ##$ #
###  .   #
##########