##########
##########
########@#
#####.  $#
##### .$ #
######$  #
######  .#
######## #
###   .$ #
##########