##########
##########
#  #######
#$ #  ####
# .$$.  ##
#    . ###
#.### $@##
#  ##  ###
# ########
##########