##########
#.##  ####
# #  #####
# $ .#####
# $  #####
#$.#######
#. #######
# $#######
#   @#####
##########