##########
##########
##########
#  #######
# ########
#  ## ## #
#.$  $ $ #
#.. .@ $ #
# ###    #
##########