##########
#### @  .#
#### . $ #
### ###. #
#      $ #
# $   #  #
# .#######
# $#######
#  #######
##########