##########
#@########
#$########
#  #######
# ########
#     ####
#.$.$ ####
# $#  ####
#.  .#####
##########