##########
##@$ .   #
#### $   #
#### $## #
#### .#  #
##### #  #
##### #. #
#######$ #
####### .#
##########