##########
##########
##########
#######  #
#.#####$@#
#  #### $#
# $####  #
# $ ###  #
#  .  . .#
##########