##########
##########
##### .  #
#####    #
######  ##
#@  .#   #
#$$ $ # ##
#.# $.  ##
####     #
##########