##########
##########
##########
#   @#####
## $ $ ###
##    .  #
###$###  #
#  $.   ##
#    . . #
##########