##########
#   .    #
# $.. $ ##
# $.$#####
####@#####
##########
##########
##########
##########
##########