##########
# ########
#  #######
#.$#######
#  #######
#. #######
# $#######
# .$ $.###
#@       #
##########