##########
# .      #
#     #.$#
###  ## .#
####.##$ #
###  $@$ #
####  ## #
##########
##########
##########