##########
###   ####
###@$ ####
#####.####
####  ####
#### $####
###  . ###
#.$      #
#.    $  #
##########