##########
##########
###  #   #
# $ .  . #
#@$ $ $. #
####### .#
####### ##
##########
##########
##########