##########
##########
#######. #
#######$ #
#######  #
#######$ #
####@##  #
# $ $ . .#
# .   #  #
##########