##########
#.    $  #
# $ .#   #
#  ##### #
#  ####  #
# #### $ #
#    .  .#
# $   # ##
# @  #####
##########