##########
##########
##########
##########
##########
###@######
#  $  # ##
#  .$  $ #
# $. . . #
##########