##########
####    @#
####$$$. #
#### .$# #
###.   ###
####.#####
##########
##########
##########
##########