##########
#        #
#   #   .#
# #####$ #
# .###   #
#    #  ##
## $.## ##
###$$.# @#
###      #
##########