##########
#  .   $@#
# $  $.$ #
####. ####
####  ####
####.#####
##########
##########
##########
##########