##########
##########
#.########
# ########
#  #@   ##
#  #  $ ##
#  ..$   #
#.$  $  ##
##       #
##########