##########
##########
##########
# @#######
#$$    ###
#   .#####
#   # .$ #
#.$#     #
#.    ####
##########