##########
######## #
###### . #
#  ####  #
#  ###  ##
# @###$  #
# $### $ #
#  ##  $ #
#   .. . #
##########