##########
#@   #####
# $  #####
# # ######
#     ####
#        #
#   #..$.#
#   # $$.#
#   #    #
##########