##########
##########
## ### ###
# .      #
#    . @$#
# #####$ #
#  #### .#
# $####$ #
#   .    #
##########