##########
###.     #
### $$ $ #
### .##$ #
###  ##. #
######@  #
####  .  #
######   #
######## #
##########