##########
#  .     #
#   #    #
#  $######
#  $.. ###
#   # $ ##
####  @ ##
#####$  ##
#####. ###
##########