##########
##########
##### ####
#   # ####
# $$  ####
#@ #  .###
#  ## ####
#.$$   ###
#   ..####
##########