##########
###@######
# #$######
# $  .####
# .  #####
#..$   ###
#  # #####
#$ #######
#  #######
##########