##########
##########
##########
##########
######@###
# $  .$  #
#  .  . ##
# ###$$###
#   .   ##
##########