##########
#    #####
#.$  #####
#   ######
# $#######
#  #  ####
# .   . ##
#$$#.  ###
#@ ### ###
##########