##########
##########
##########
######  ##
#.$   .  #
# $ .#   #
# ####. ##
#@$ ## $##
#   ##  ##
##########