##########
#### .   #
####   #$#
#### $## #
####  ## #
##### .@ #
###### $ #
######$ .#
###### . #
##########