##########
#  @     #
# . $##  #
###. ##. #
### $ #. #
### $ #  #
### $    #
##### #  #
#######  #
##########