##########
##########
##########
##########
##########
#. #######
# $  #####
#.$ . $ ##
#    $@. #
##########