##########
##########
#######@ #
#######$.#
#######  #
######  .#
##### .$ #
#####  $$#
#####.   #
##########