##########
#   ######
#  . #####
#  #.$@###
# .#. ####
#  $ $$ ##
#       ##
##########
##########
##########