##########
#     .  #
#@ #  #  #
# ##### .#
#.     $ #
#   $ #  #
# $$#### #
#  .#### #
##########
##########