##########
#   . .###
# .#    ##
#  # $  ##
#@  # $.##
# $##   ##
#  ## $ ##
## ##  ###
######  ##
##########