##########
##########
##########
##########
# @ ######
# $ ######
# $# ## ##
#.$   $ ##
# . .  . #
##########