##########
##########
##########
#######  #
#.#####$ #
# #####. #
# $   . .#
#$$##### #
#@       #
##########