##########
######## #
#######  #
#######. #
#######$ #
#######  #
## $@  . #
##. .$ $ #
#######  #
##########