##########
######.$ #
###### $.#
#######  #
#######$ #
####### @#
#######$ #
###### . #
####  .  #
##########