##########
####@$.  #
#### $.. #
#######  #
#######$ #
#######. #
#######  #
#######$ #
#        #
##########