##########
# $ . .$ #
#      $@#
# # ######
#  #######
# ########
#  #######
# ########
#.$.######
##########