##########
# .      #
#  .@$.$.#
#   ###  #
# $####  #
#  ####$ #
#######  #
##########
##########
##########