##########
##########
######  ##
#####  ###
######. ##
#####. ###
##### $###
#   #$$ ##
#. $ @ .##
##########