##########
#####    #
##### . .#
#######$ #
#######  #
#### ### #
#   .    #
# $ $$ . #
#   @ ## #
##########