##########
##########
# # ## ###
#  . .  ##
#    # $##
######  ##
#  ### $ #
# $##  $@#
#      ..#
##########