##########
########.#
# ###### #
#   ###  #
#. $@###.#
# #####  #
#  ####$ #
# #### $$#
#      . #
##########