##########
######## #
######## #
#######. #
# @####$ #
#  ####  #
## #####.#
## $ .$  #
## $   . #
##########