##########
#       .#
## .$. $ #
##  ## ###
##  ######
##  ######
###.### ##
## $  $ ##
##  @    #
##########