##########
#  #######
# $@######
# $$##   #
# ..###$ #
# ####.  #
# ####   #
# ### ## #
#.       #
##########