##########
######## #
######.  #
##@####  #
# $#### ##
#   ##  .#
# .  .  ##
# $$  $ ##
#  #######
##########