##########
# ########
# #     ##
#     . ##
#.#    ###
#.  ######
# $ ######
#$$$######
# .@######
##########