##########
##########
##########
##########
#### #####
####   ###
####$$. ##
#### $.$@#
##.  .  ##
##########