##########
# ########
#  #######
#. #######
# $ $.   #
# $  #   #
#.  ######
#$#.######
# @#######
##########