##########
#. ##### #
#  ##### #
#  ####  #
#@#####. #
# $    . #
# $ $   .#
# #####$ #
# #####  #
##########