##########
# #   .  #
#. #.    #
# # ###  #
#.$    $##
#  $#   ##
# $ ######
#@ #######
##########
##########