##########
## .######
#   . $@##
#.. #$ ###
#  ##   ##
#   #$ ###
#$ ##   ##
#  #######
##########
##########