##########
#   .   ##
# $# $$@##
#  ##$ ###
# # # . ##
###.  .###
###    ###
##########
##########
##########