##########
#@ #######
#$$#######
# . ######
#.  .#####
# .$ #####
#  #######
# $ ######
#   ######
##########