##########
#  .######
# $ ######
#  #######
#.########
# @#### ##
#. ##    #
# $$ . $ #
#  #     #
##########