##########
#  #######
# # ######
#  $  @.##
# $   $ ##
#  ####.##
# ####  ##
# .      #
# $.##   #
##########