##########
#    . $ #
# $ #    #
#.#####  #
######## #
###@$.   #
## $  #  #
## . #####
##########
##########