##########
###  #####
## .   ###
#  @.#####
# #  #####
# # #  ###
# #.$ .###
# $$#$  ##
#      ###
##########