##########
#  @    ##
#$$$  ####
#.  ######
##. ######
##.$ #####
##. ######
##  ######
##########
##########