##########
### $  . #
###.   $ #
########.#
######## #
#######  #
##.##### #
# $$     #
#@ # #   #
##########