##########
##      ##
## . $   #
## $##   #
## @###$##
###$### ##
###  #   #
##.  ## ##
##.  .  ##
##########