##########
##########
##########
##########
##########
###  #####
#.$  $@###
#. $$..###
#     ####
##########