##########
##########
##########
##########
##########
#######  #
####.. $ #
#### $.$@#
#### $  .#
##########