##########
# .      #
#  # . $ #
#. ##.$###
# $###  ##
#  ### ###
# $      #
#@ #    ##
##########
##########