##########
#        #
# $ $  ###
####  ####
#### .####
#####. ###
#### .#  #
### $@ $ #
### .    #
##########