##########
#      ###
#   $$ ###
# ###@####
# ##.$ ###
#  ##  ###
# .  $.###
#.  # ####
#  #  ####
##########