##########
### .    #
###   .  #
#######  #
#######  #
###### $ #
#####   .#
#@$    $ #
# $.#  # #
##########