##########
### @##. #
###  $ .$#
### $  . #
#######  #
#######$ #
#######  #
########.#
##########
##########