##########
##########
## ####@ #
#   .  $ #
# $. #  ##
### ##$  #
#.  ##  ##
# $ ### ##
#   ###.##
##########