##########
###      #
### $    #
##   ### #
##$# ### #
##  #### #
#  #### @#
#.$    $.#
#   .. # #
##########