##########
#.   #   #
#   $.   #
#. $ #  .#
#$ ####  #
#   ##  ##
## ###  ##
# $#######
##@#######
##########