##########
##########
######@###
######$###
#####  ###
######  ##
# ## $  ##
#. $ .$ ##
# . .  ###
##########