##########
#  $   . #
#.   $.$ #
##.#######
##  ######
# $ ######
#    #####
###  #####
### @ ####
##########