##########
##    .###
### $  ###
# ### $ ##
#@$.  $. #
#   #    #
#####   .#
######  ##
######  ##
##########