##########
##########
#####  ###
#####@$###
#####  ###
#####.$ ##
##### .$##
#####.$. #
#####    #
##########