##########
#  #######
#   ######
#.. ######
#  $@#####
# $$######
#  $ #####
#. # #####
#  .   ###
##########