##########
# .    ###
# $  . ###
##### ####
#### .####
####@$####
####   ###
## # $$###
#     .###
##########