##########
#. #######
# $#######
#  #######
#$ ##### #
#@ ##### #
#$ # .#  #
#. $    .#
#  #  ## #
##########