##########
##@   .. #
## $$ #  #
##. ###  #
### ###  #
## .###$ #
##  ###  #
##  ## $ #
#######  #
##########