##########
#        #
#  @ $ $##
#  ###.. #
#.####.  #
# ####   #
# ### $  #
# ###  $ #
#######  #
##########