##########
#.   . ###
#  .$ ####
# #$ #####
# $  #####
#.##  ####
#  #  ####
#   $#####
####@#####
##########