##########
#@       #
#  #$$ $ #
###   # .#
###  ##$ #
## .  #  #
### ..####
#### #####
##########
##########