##########
#    #####
#.$.$#####
# $$  ####
# . . ####
## #@#####
##########
##########
##########
##########