##########
#  . #####
#   ######
#   ######
# $ ######
# .#  ####
#  . $  ##
# $$ . ###
##@##  ###
##########