##########
#    . ###
## $  ####
###   ####
## .  ####
##  # ####
## $#  @##
## $. $ ##
###.     #
##########