##########
# .#######
# $ #### #
#      $ #
# $ #  #@#
# .#######
#.$ # ####
#  .   ###
#   #  ###
##########