##########
# . .  ###
#   $ ####
#  ..$ ###
# ##   ###
#  #$$####
#  #@  ###
# ########
# ########
##########