##########
##########
##########
###### ###
###      #
## #$$  @#
## $ ###.#
#. $.### #
#     .  #
##########