##########
# .   ####
# $@ $####
#  ## ####
# $#  ####
#  ## ####
# ##. ####
####   $ #
# . .    #
##########