##########
##########
##########
#@   #####
#.$$######
##  ######
###  #####
##  .$.  #
#    .$  #
##########