##########
######## #
##### .  #
##### $. #
#######  #
#######$.#
####@$   #
#### $   #
##### #. #
##########