##########
##########
##########
##########
#.  @ ####
# $$$#####
###. ##  #
##     $ #
#   ..   #
##########