##########
##########
##########
##########
# # ######
# . ######
#  $@#####
#.$#$  ###
#.$   .###
##########