##########
#  # #####
#   . ####
#  #. ####
#  # $@###
# .#  ####
# ##  ####
#  $$$ ###
# .    ###
##########