##########
##########
##########
##########
###   # ##
### .$. ##
# $      #
#@$# # $ #
# .####. #
##########