##########
###@######
###$######
##. ######
##   #####
##  $ ####
###.$ ####
##.$   ###
#    . ###
##########