##########
#       ##
#  $$ ####
#.@# #####
# # . ####
# $  #####
# $ ######
#  .#  ###
##     . #
##########