##########
##@#######
# $      #
## $### ##
##..######
#  $######
#  . #####
#. $ #####
#   ######
##########