##########
###  .  @#
####  #  #
#### ##  #
###  ##..#
###  ##  #
#### $  .#
#### $$$ #
######   #
##########