##########
#    .   #
# .$$ $$.#
#  @ ##  #
#.# ######
### ######
##########
##########
##########
##########