##########
######## #
## ## #  #
# $   $  #
# $  ... #
#  #######
# . $@####
#   ######
##########
##########