##########
### ####.#
#      . #
#.$ # #  #
####### $#
#######. #
#######  #
### $  $@#
##       #
##########