##########
#   $  @.#
#. $ $.$ #
#.#   ####
# ########
# ########
##########
##########
##########
##########