##########
#    #####
# $. #####
#@#  .####
####  ####
###  ##  #
#### . $ #
####$# $ #
####.    #
##########