##########
##########
##########
##########
######@###
##    $  #
###  ..$$#
#####. $.#
####     #
##########