##########
##### #  #
###  $ . #
### .. $.#
#######  #
#######  #
#######$$#
### @    #
####  ## #
##########