##########
# $  .  ##
#   . $.##
#.###  ###
# ###  ###
# ####  ##
# ####$###
#  ## $  #
#  ##   @#
##########