##########
# .  .####
# $ $ ####
# .#######
# $#######
#.     $@#
#   ## ###
# ########
#  #######
##########