##########
##########
#### $  .#
###    $ #
#### ### #
#### ##  #
###  ##$ #
### . #. #
#@$  .   #
##########