##########
##### ####
#### ..  #
###@$.$$ #
#### $.  #
####  ####
####  ####
##### ####
##########
##########