##########
#  # #   #
#    ..$ #
# @#    ##
#  ###$ ##
#.$$.    #
#  # ## ##
##########
##########
##########