##########
### .  .##
##@$  $ ##
###$ #####
##  ######
###   ####
###.$ ####
##   #  ##
##     .##
##########