##########
#@  ######
#$$#######
#  ####  #
#. ##  $ #
#$ ###   #
#  ####. #
#. ## #  #
#  .     #
##########