##########
##########
##########
##.#######
##  # ####
# @.$   .#
# .  $ # #
# $ ## $ #
#        #
##########