##########
#####    #
##### $$ #
#####  # #
# .##.$@ #
#  ##.   #
#  ####  #
##$ ###. #
#        #
##########