##########
#    .   #
###   .  #
####  #. #
###  #####
###    ###
# .$$$$ ##
#   @   ##
# ########
##########