##########
#   ..  .#
#   $ $$ #
# .####  #
##$ #### #
##@#######
##########
##########
##########
##########