##########
#.       #
#   $ .  #
#  $#### #
##  #### #
##$####  #
# @ #### #
######  .#
##.    $ #
##########