##########
##########
##########
## ###   #
# $   .  #
#@$.  #  #
#  #    .#
##$ # $# #
#    .   #
##########