##########
#. .$    #
#  $ . .##
# ###$$###
##### @ ##
##########
##########
##########
##########
##########