##########
##     ..#
#### $   #
######. ##
#####  ###
###### ###
## ## $ ##
## .$ $@##
#        #
##########