##########
# $  .   #
#  . .   #
#  #### ##
##$   ####
##  .#####
###  #####
###$$ ####
###@ #####
##########