##########
###### . #
######. $#
#######  #
#######$ #
#####  . #
##### $ .#
#######$ #
#######@ #
##########