##########
#####@   #
###### $ #
######## #
######## #
######## #
##### #  #
# $.$  $ #
#   . . .#
##########