##########
#        #
#   .    #
#. $ ##  #
#   #### #
###.# ## #
##     $ #
### .$$# #
####@    #
##########