##########
##########
####### @#
########$#
#######  #
#######. #
#### ##$.#
# $ $ .  #
#      . #
##########