##########
########@#
########$#
#######  #
####### .#
####.    #
### . $# #
# #  $$ ##
#      . #
##########