##########
#  #  ####
# ## $ ###
# $  @ #.#
#     #  #
# $#..## #
#. ## #  #
##### # $#
#####    #
##########