##########
######.###
#  .  $  #
#   $ $ ##
######   #
##### # ##
####  # ##
###@   $ #
#. .     #
##########