##########
# ###  ###
# #  .  .#
# ## $   #
#  #$$ ###
#.    . ##
#  # #$###
# ####@###
##########
##########