##########
#    #####
#@$ $ ####
#     ####
# # $ ####
#.##  ####
# #  #.  #
#      $ #
#  # # ..#
##########