##########
#### $ ..#
#### $.  #
#### . $ #
###### ###
###### ###
###### ###
######$ ##
######@###
##########