##########
#### @   #
#### $ $ #
#####.#  #
####  #..#
# #    # #
#     #  #
# $$  #  #
# . ######
##########