##########
#        #
# . $$$ ##
#.### @###
#   # ####
# $ . .###
#  #  ####
##########
##########
##########