##########
##########
##########
########@#
####### $#
###### $ #
#######..#
# $  $   #
#  ..    #
##########