##########
#@ #######
# $#######
#  #######
#. #######
#. #######
#  #  ####
#.$$ $ ###
#   .   ##
##########