##########
#####.####
###    $ #
####   # #
###  ##  #
###   #$.#
###  ##  #
#### .$ $#
###@   . #
##########