##########
# . @.. ##
# .$  $ ##
# $$ #####
#  #######
#  #######
# ########
# ########
#   ######
##########