##########
##########
##########
###  ## ##
###$   $ #
##  . # .#
###. ###@#
##  $# $ #
#    .   #
##########