##########
##########
#@ #######
# $#  ####
#..$$ ####
#   $ ####
#.### ####
#  #  .###
#      ###
##########