##########
### ###  #
# $      #
#   # .  #
# #####  #
#  ###@$ #
#  ###$ ##
#### $ . #
####..   #
##########