##########
## # #####
#.  .  ###
#     $  #
#. #   # #
## ## #  #
#  $.$ $@#
### #    #
##########
##########