##########
##.  #####
##.  #####
##  $##@ #
##    .$ #
##  #  $.#
#######$ #
#######  #
######   #
##########