##########
# #    ###
#. $    ##
#.   #$###
#  ##  ###
# $##    #
#   #  . #
# $#   . #
#    @   #
##########