##########
#  .   $@#
# $ .$  ##
#### .####
####$ ####
#### .####
#####  ###
#     ####
#   # ####
##########