##########
#        #
#.   $. ##
# #### ###
#  ### @##
# ####$###
#.  #  ###
#  .$ $ ##
#      ###
##########