##########
#     ####
# $@$  ###
#  ##.####
# ## . ###
# ##.  ###
# ##  ####
#### $ $ #
#### .   #
##########