##########
#  #######
# #@##.###
# $$   ###
# $ $ .###
# .  #####
# . ######
# ########
#  #######
##########