##########
#       @#
# $   .$ #
## ##.####
#   # ..##
#   #    #
## ## $$ #
#  ##    #
##  ######
##########