##########
#### .  @#
####   $$#
##### #  #
####  #$ #
##### #. #
#######  #
#######$.#
######  .#
##########