##########
## #######
## #######
##  ######
#   ##  .#
#   ## ..#
#  ###  ##
##   $$$ #
#   .  $@#
##########