##########
#.     $ #
#  .## $ #
#  ###.  #
#  ###   #
# $@######
#  .######
# $#######
#  #######
##########