##########
####### ##
####.#  ##
#  .$  . #
#  #@##  #
# #####  #
# $ $  $ #
#    #.  #
### ######
##########