##########
#       .#
# . . $  #
## ####  #
## ####  #
##    #$ #
## $.##  #
########$#
#@       #
##########