##########
#######@ #
#######$.#
#######  #
#######$$#
#  #### .#
#       $#
#   # # .#
#######. #
##########