##########
#       ##
##.  $  ##
####.# ###
##  $  $@#
###  # $.#
### .#  ##
##  ######
##       #
##########