##########
# .   ####
#  # $ ###
# ##  ####
# ## .####
# ##$$ ###
# .     ##
#@$  .  ##
#     ####
##########