##########
##    .  #
##@ $.   #
#  ##. ###
# $##$  ##
#  ## .###
#     $  #
##      ##
##########
##########