##########
##########
##########
##########
##########
##  ### @#
## $## $$#
##  .#.$ #
### .   .#
##########