##########
#  . #####
#. $.#####
# $$   ###
#   ######
# .#######
# ########
#$ #######
# @#######
##########