##########
##########
##########
#.#  #  @#
#    .$$ #
#  $  .$ #
# .#######
# ########
##########
##########