##########
#######. #
#######$ #
####     #
## $..$  #
#  #$ #  #
#    ##. #
# @####  #
#  #######
##########