##########
# #####  #
#  ####$ #
# $     .#
# $. # $ #
#@ ####. #
# ####.  #
# ####  ##
##########
##########