##########
#  #######
# $#######
#   .#####
# # $#####
###  ## @#
###. ##$ #
### $.#  #
##      .#
##########