##########
#######  #
######   #
######## #
#######  #
### ###$.#
#@$  .  .#
# $$   . #
#   #### #
##########